"Company","booking_date","amount","balance","tags"
"1","16/9/2019 00:00:00+00","6300","1372781","[revenue]"
"1","16/9/2019 00:00:00+00","40","1372821","[revenue, sales]"
"1","16/9/2019 00:00:00+00","2650","1375471","[revenue, sales]"
"1","16/9/2019 00:00:00+00","2350","1377821","[revenue]"
"1","16/9/2019 00:00:00+00","2350.22","1380171.22","[revenue, sales]"
"1","16/9/2019 00:00:00+00","2420","1382591.22","[revenue]"
"1","16/9/2019 00:00:00+00","27763.87","1410355.09","[revenue, chargeback, sales]"
"1","16/9/2019 00:00:00+00","-4","1410351.09","[expenditure]"
"1","16/9/2019 00:00:00+00","-1190.48","1409160.61","[expenditure, administration, material-supply]"
"1","16/9/2019 00:00:00+00","-23182.96","1385977.65","[expenditure, credit-card, credit, material-supply]"
"1","17/9/2019 00:00:00+00","-2802.25","1383175.4","[expenditure, rent]"
"1","17/9/2019 00:00:00+00","-476","1382699.4","[expenditure, material-supply]"
"1","17/9/2019 00:00:00+00","-140.46","1382558.94","[expenditure, material-supply]"
"1","17/9/2019 00:00:00+00","-66.81","1382492.13","[expenditure, material-supply]"
"1","17/9/2019 00:00:00+00","-22.98","1382469.15","[expenditure, material-supply]"
"1","17/9/2019 00:00:00+00","-200","1382269.15","[expenditure, salary, material-supply]"
"1","17/9/2019 00:00:00+00","-110.43","1382158.72","[expenditure, material-supply]"
"1","17/9/2019 00:00:00+00","-559.3","1381599.42","[expenditure, material-supply]"
"1","17/9/2019 00:00:00+00","-115.43","1381483.99","[expenditure, material-supply]"
"1","17/9/2019 00:00:00+00","-40.8","1381443.19","[expenditure]"
"1","17/9/2019 00:00:00+00","-252.9","1381190.29","[expenditure, material-supply]"
"1","17/9/2019 00:00:00+00","-428.2","1380762.09","[expenditure, material-supply]"
"1","17/9/2019 00:00:00+00","-5440.77","1375321.32","[expenditure, material-supply]"
"1","17/9/2019 00:00:00+00","-535.64","1374785.68","[expenditure, material-supply]"
"1","17/9/2019 00:00:00+00","-2800","1371985.68","[expenditure, material-supply]"
"1","17/9/2019 00:00:00+00","-694.6","1371291.08","[expenditure, material-supply]"
"1","17/9/2019 00:00:00+00","-2584.05","1368707.03","[expenditure, material-supply]"
"1","17/9/2019 00:00:00+00","-30","1368677.03","[expenditure, material-supply]"
"1","17/9/2019 00:00:00+00","-264.99","1368412.04","[expenditure, material-supply]"
"1","17/9/2019 00:00:00+00","-1405.05","1367006.99","[expenditure, material-supply]"
"1","17/9/2019 00:00:00+00","-1602.62","1365404.37","[expenditure, material-supply]"
"1","17/9/2019 00:00:00+00","-1382.45","2222318.98","[expenditure, material-supply]"
"1","17/9/2019 00:00:00+00","-3900","2218418.98","[expenditure, material-supply]"
"1","17/9/2019 00:00:00+00","-2844.51","2215574.47","[expenditure, material-supply]"
"1","17/9/2019 00:00:00+00","-40.8","2215533.67","[expenditure]"
"1","17/9/2019 00:00:00+00","-847.3","2214686.37","[expenditure, material-supply]"
"1","17/9/2019 00:00:00+00","-6580","1358824.37","[expenditure, material-supply]"
"1","17/9/2019 00:00:00+00","-1529","1357295.37","[expenditure, material-supply]"
"1","17/9/2019 00:00:00+00","-2168.71","1355126.66","[expenditure, material-supply]"
"1","17/9/2019 00:00:00+00","-11790","1343336.66","[expenditure, material-supply]"
"1","17/9/2019 00:00:00+00","-40","2214646.37","[expenditure, material-supply]"
"1","17/9/2019 00:00:00+00","-2571.4","2212074.97","[expenditure, material-supply]"
"1","17/9/2019 00:00:00+00","-4174.9","2207900.07","[expenditure, material-supply]"
"1","17/9/2019 00:00:00+00","-0.05","2207900.02","[expenditure, material-supply]"
"1","17/9/2019 00:00:00+00","-5150","2202750.02","[expenditure, material-supply]"
"1","17/9/2019 00:00:00+00","-582.35","2202167.67","[expenditure, material-supply]"
"1","17/9/2019 00:00:00+00","-0.15","2202167.52","[expenditure, material-supply]"
"1","17/9/2019 00:00:00+00","-1161.69","2201005.83","[expenditure, material-supply]"
"1","17/9/2019 00:00:00+00","-2069","1341267.66","[expenditure, material-supply]"
"1","17/9/2019 00:00:00+00","-4815.95","1336451.71","[expenditure, material-supply]"
"1","17/9/2019 00:00:00+00","-7652","1328799.71","[expenditure, material-supply]"
"1","17/9/2019 00:00:00+00","-0.09","1328799.62","[expenditure, material-supply]"
"1","17/9/2019 00:00:00+00","50000","1378799.62","[revenue, sales]"
"1","17/9/2019 00:00:00+00","5990","1384789.62","[revenue, sales]"
"1","17/9/2019 00:00:00+00","21779.28","1406568.9","[revenue, sales]"
"1","17/9/2019 00:00:00+00","14126.71","1420695.61","[revenue, sales]"
"1","17/9/2019 00:00:00+00","-75","1420620.61","[expenditure]"
"1","17/9/2019 00:00:00+00","-19.22","1420601.39","[expenditure]"
"1","17/9/2019 00:00:00+00","-19","2200986.83","[expenditure]"
"1","17/9/2019 00:00:00+00","-19","2200967.83","[expenditure]"
"1","17/9/2019 00:00:00+00","-19","2200948.83","[expenditure]"
"1","17/9/2019 00:00:00+00","-19","2200929.83","[expenditure]"
"1","17/9/2019 00:00:00+00","-19","2200910.83","[expenditure]"
"1","17/9/2019 00:00:00+00","-4","2200906.83","[expenditure]"
"1","17/9/2019 00:00:00+00","-19","2200887.83","[expenditure]"
"1","17/9/2019 00:00:00+00","-19","1420582.39","[expenditure]"
"1","17/9/2019 00:00:00+00","-19","2200868.83","[expenditure]"
"1","17/9/2019 00:00:00+00","-19","2200849.83","[expenditure]"
"1","17/9/2019 00:00:00+00","-19","2200830.83","[expenditure]"
"1","17/9/2019 00:00:00+00","-19","1420563.39","[expenditure]"
"1","17/9/2019 00:00:00+00","-19","1420544.39","[expenditure]"
"1","17/9/2019 00:00:00+00","-19","1420525.39","[expenditure]"
"1","17/9/2019 00:00:00+00","-19","1420506.39","[expenditure]"
"1","17/9/2019 00:00:00+00","-19","1420487.39","[expenditure]"
"1","17/9/2019 00:00:00+00","-19","1420468.39","[expenditure]"
"1","17/9/2019 00:00:00+00","-19","2200811.83","[expenditure]"
"1","17/9/2019 00:00:00+00","-19","2200792.83","[expenditure]"
"1","17/9/2019 00:00:00+00","-19","2200773.83","[expenditure]"
"1","17/9/2019 00:00:00+00","-30.01","2200743.82","[expenditure]"
"1","17/9/2019 00:00:00+00","-19","2200724.82","[expenditure]"
"1","17/9/2019 00:00:00+00","-19","2200705.82","[expenditure]"
"1","17/9/2019 00:00:00+00","-10","2200695.82","[expenditure, material-supply]"
"1","17/9/2019 00:00:00+00","-10","2200685.82","[expenditure, material-supply]"
"1","18/9/2019 00:00:00+00","-0.26","2200685.56","[expenditure, material-supply]"
"1","18/9/2019 00:00:00+00","-0.3","2200685.26","[expenditure, material-supply]"
"1","18/9/2019 00:00:00+00","-1440","2199245.26","[expenditure, material-supply]"
"1","18/9/2019 00:00:00+00","-6548.89","2192696.37","[expenditure, material-supply]"
"1","18/9/2019 00:00:00+00","-9102.62","2183593.75","[expenditure, material-supply]"
"1","18/9/2019 00:00:00+00","-0.13","2183593.62","[expenditure, material-supply]"
"1","18/9/2019 00:00:00+00","-2125.14","2181468.48","[expenditure, material-supply]"
"1","18/9/2019 00:00:00+00","-1735","2179733.48","[expenditure, material-supply]"
"1","18/9/2019 00:00:00+00","-1431","2178302.48","[expenditure, material-supply]"
"1","18/9/2019 00:00:00+00","-24.7","2178277.78","[expenditure]"
"1","18/9/2019 00:00:00+00","-2946.02","2175331.76","[expenditure]"
"1","18/9/2019 00:00:00+00","-3.55","2175328.21","[expenditure]"
"1","18/9/2019 00:00:00+00","4799.23","2180127.44","[revenue, sales]"
"1","18/9/2019 00:00:00+00","7310","2187437.44","[revenue]"
"1","18/9/2019 00:00:00+00","60","2187497.44","[revenue]"
"1","18/9/2019 00:00:00+00","3730","2191227.44","[revenue, sales]"
"1","18/9/2019 00:00:00+00","100","2191327.44","[revenue]"
"1","18/9/2019 00:00:00+00","147.5","1420615.89","[revenue]"
"1","18/9/2019 00:00:00+00","100","1420715.89","[revenue]"
"1","18/9/2019 00:00:00+00","1969.6","1422685.49","[revenue, sales]"
"1","18/9/2019 00:00:00+00","3.55","1422689.04","[revenue, sales]"
"1","18/9/2019 00:00:00+00","27763.87","1450452.91","[revenue, chargeback, sales]"
"1","18/9/2019 00:00:00+00","-4","1450448.91","[expenditure, credit-card]"
"1","18/9/2019 00:00:00+00","-19","2191308.44","[expenditure]"
"1","18/9/2019 00:00:00+00","-19","2191289.44","[expenditure]"
"1","18/9/2019 00:00:00+00","-19","2191270.44","[expenditure]"
"1","18/9/2019 00:00:00+00","-19","2191251.44","[expenditure]"
"1","18/9/2019 00:00:00+00","-19","2191232.44","[expenditure]"
"1","19/9/2019 00:00:00+00","-660","2190572.44","[expenditure]"
"1","19/9/2019 00:00:00+00","-937.46","2189634.98","[expenditure, material-supply]"
"1","19/9/2019 00:00:00+00","-887","2188747.98","[expenditure, material-supply]"
"1","19/9/2019 00:00:00+00","-1748.4","2186999.58","[expenditure, material-supply]"
"1","19/9/2019 00:00:00+00","-2548","2184451.58","[expenditure, material-supply]"
"1","19/9/2019 00:00:00+00","-1452","2182999.58","[expenditure, material-supply]"
"1","19/9/2019 00:00:00+00","-30","2182969.58","[expenditure, material-supply]"
"1","19/9/2019 00:00:00+00","-3259.18","2179710.4","[expenditure, material-supply]"
"1","19/9/2019 00:00:00+00","-277.6","2179432.8","[expenditure, material-supply]"
"1","19/9/2019 00:00:00+00","-255.85","2179176.95","[expenditure, material-supply]"
"1","19/9/2019 00:00:00+00","-165.41","2179011.54","[expenditure, material-supply]"
"1","19/9/2019 00:00:00+00","-255.85","2178755.69","[expenditure, material-supply]"
"1","19/9/2019 00:00:00+00","-255.85","2178499.84","[expenditure, material-supply]"
"1","19/9/2019 00:00:00+00","-1368.5","2177131.34","[expenditure, law, tax, material-supply]"
"1","19/9/2019 00:00:00+00","-345.15","2176786.19","[expenditure, material-supply]"
"1","19/9/2019 00:00:00+00","-4782.61","2172003.58","[expenditure, material-supply]"
"1","19/9/2019 00:00:00+00","-349.75","2171653.83","[expenditure, material-supply]"
"1","19/9/2019 00:00:00+00","-148.75","2171505.08","[expenditure, material-supply]"
"1","19/9/2019 00:00:00+00","-712.5","2170792.58","[expenditure, material-supply]"
"1","19/9/2019 00:00:00+00","-59.43","2170733.15","[expenditure, material-supply]"
"1","19/9/2019 00:00:00+00","5489.97","2176223.12","[revenue]"
"1","19/9/2019 00:00:00+00","3730","2179953.12","[revenue]"
"1","19/9/2019 00:00:00+00","5137.08","2185090.2","[revenue, sales]"
"1","19/9/2019 00:00:00+00","8900","2193990.2","[revenue, sales]"
"1","19/9/2019 00:00:00+00","4000","2197990.2","[revenue, sales]"
"1","19/9/2019 00:00:00+00","30","1450478.91","[revenue]"
"1","19/9/2019 00:00:00+00","14125.12","1464604.03","[revenue, sales]"
"1","19/9/2019 00:00:00+00","-545","1464059.03","[expenditure, material-supply]"
"1","19/9/2019 00:00:00+00","-19","1464040.03","[expenditure]"
"1","19/9/2019 00:00:00+00","-19","1464021.03","[expenditure]"
"1","19/9/2019 00:00:00+00","-28.23","2197961.97","[expenditure]"
"1","19/9/2019 00:00:00+00","-19","2197942.97","[expenditure]"
"1","19/9/2019 00:00:00+00","-27.61","2197915.36","[expenditure]"
"1","19/9/2019 00:00:00+00","-34.99","1463986.04","[expenditure, material-supply]"
"1","19/9/2019 00:00:00+00","-4","1463982.04","[expenditure, material-supply]"
"1","20/9/2019 00:00:00+00","-7370","1456612.04","[expenditure, material-supply]"
"1","20/9/2019 00:00:00+00","-4000","1452612.04","[expenditure, material-supply]"
"1","20/9/2019 00:00:00+00","-7950","1444662.04","[expenditure, material-supply]"
"1","20/9/2019 00:00:00+00","-5820","1438842.04","[expenditure, material-supply]"
"1","20/9/2019 00:00:00+00","-1666.89","1437175.15","[expenditure, material-supply]"
"1","20/9/2019 00:00:00+00","-3140","1434035.15","[expenditure, material-supply]"
"1","20/9/2019 00:00:00+00","-250","1433785.15","[expenditure, material-supply]"
"1","20/9/2019 00:00:00+00","-5005","1428780.15","[expenditure, material-supply]"
"1","20/9/2019 00:00:00+00","-6270","1422510.15","[expenditure, material-supply]"
"1","20/9/2019 00:00:00+00","-8370","1414140.15","[expenditure, material-supply]"
"1","20/9/2019 00:00:00+00","-7350","1406790.15","[expenditure, material-supply]"
"1","20/9/2019 00:00:00+00","-1690","1405100.15","[expenditure]"
"1","20/9/2019 00:00:00+00","-27763.87","1377336.28","[expenditure, material-supply]"
"1","20/9/2019 00:00:00+00","1800","1379136.28","[revenue]"
"1","20/9/2019 00:00:00+00","10100","1389236.28","[revenue, sales]"
"1","20/9/2019 00:00:00+00","2140","1391376.28","[revenue]"
"1","20/9/2019 00:00:00+00","14758.88","1406135.16","[revenue, sales]"
"1","20/9/2019 00:00:00+00","-4","1406131.16","[expenditure]"
"1","20/9/2019 00:00:00+00","-56.69","1406074.47","[expenditure]"
"1","20/9/2019 00:00:00+00","-28.38","2197886.98","[expenditure]"
"1","20/9/2019 00:00:00+00","-4","2197882.98","[expenditure, credit-card]"
"1","20/9/2019 00:00:00+00","-29.06","2197853.92","[expenditure]"
"1","20/9/2019 00:00:00+00","-30.35","2197823.57","[expenditure]"
"1","20/9/2019 00:00:00+00","-28.1","2197795.47","[expenditure]"
"1","20/9/2019 00:00:00+00","-19","2197776.47","[expenditure]"
"1","20/9/2019 00:00:00+00","-460.72","2197315.75","[expenditure, material-supply]"
"1","20/9/2019 00:00:00+00","-95.2","2197220.55","[expenditure, credit, material-supply]"
"1","20/9/2019 00:00:00+00","-1658.23","1404416.24","[expenditure]"
"1","23/9/2019 00:00:00+00","2960","2200180.55","[revenue, sales]"
"1","23/9/2019 00:00:00+00","1482.97","2201663.52","[revenue, sales]"
"1","23/9/2019 00:00:00+00","3690","2205353.52","[revenue, sales]"
"1","23/9/2019 00:00:00+00","5825.26","2211178.78","[revenue, sales]"
"1","23/9/2019 00:00:00+00","3244.79","2214423.57","[revenue, sales]"
"1","23/9/2019 00:00:00+00","2355.3","2216778.87","[revenue, sales]"
"1","23/9/2019 00:00:00+00","3877.04","2220655.91","[revenue, sales]"
"1","23/9/2019 00:00:00+00","1220","2221875.91","[revenue]"
"1","23/9/2019 00:00:00+00","4500","2226375.91","[revenue]"
"1","23/9/2019 00:00:00+00","110.84","2226486.75","[revenue, sales]"
"1","23/9/2019 00:00:00+00","618.7","2227105.45","[revenue, chargeback, sales]"
"1","23/9/2019 00:00:00+00","-4","2227101.45","[expenditure, credit-card]"
"1","23/9/2019 00:00:00+00","-38.08","2227063.37","[expenditure, material-supply, cash]"
"1","23/9/2019 00:00:00+00","-116.52","2226946.85","[expenditure]"
"1","23/9/2019 00:00:00+00","-320","2226626.85","[expenditure, credit, material-supply]"
"1","23/9/2019 00:00:00+00","-10","2226616.85","[expenditure, credit, material-supply]"
"1","23/9/2019 00:00:00+00","-10","2226606.85","[expenditure, credit, material-supply]"
"1","23/9/2019 00:00:00+00","-10","2226596.85","[expenditure, administration, credit, material-supply]"
"1","23/9/2019 00:00:00+00","-10","2226586.85","[expenditure, administration, credit, material-supply]"
"1","23/9/2019 00:00:00+00","-75","2226511.85","[expenditure, credit, material-supply]"
"1","23/9/2019 00:00:00+00","-87.5","2226424.35","[expenditure, credit, material-supply]"
"1","23/9/2019 00:00:00+00","-40","2226384.35","[expenditure, credit, material-supply]"
"1","23/9/2019 00:00:00+00","-120","2226264.35","[expenditure, credit, material-supply]"
"1","24/9/2019 00:00:00+00","-2269.12","2223995.23","[expenditure, material-supply]"
"1","24/9/2019 00:00:00+00","-178.5","2223816.73","[expenditure, material-supply]"
"1","24/9/2019 00:00:00+00","-178.5","2223638.23","[expenditure, material-supply]"
"1","24/9/2019 00:00:00+00","-451.32","2223186.91","[expenditure, material-supply]"
"1","24/9/2019 00:00:00+00","-4046","1400370.24","[expenditure, material-supply]"
"1","24/9/2019 00:00:00+00","-678.3","1399691.94","[expenditure, material-supply]"
"1","24/9/2019 00:00:00+00","-892.7","1398799.24","[expenditure, material-supply]"
"1","24/9/2019 00:00:00+00","-236.81","1398562.43","[expenditure, material-supply]"
"1","24/9/2019 00:00:00+00","-236.81","1398325.62","[expenditure, material-supply]"
"1","24/9/2019 00:00:00+00","-252.28","1398073.34","[expenditure, material-supply]"
"1","24/9/2019 00:00:00+00","-61.88","1398011.46","[expenditure, material-supply]"
"1","24/9/2019 00:00:00+00","-60.69","1397950.77","[expenditure, material-supply]"
"1","24/9/2019 00:00:00+00","-60.69","1397890.08","[expenditure, material-supply]"
"1","24/9/2019 00:00:00+00","-31.34","2223155.57","[expenditure, material-supply]"
"1","24/9/2019 00:00:00+00","-737.06","1397153.02","[expenditure, transport, material-supply]"
"1","24/9/2019 00:00:00+00","-562.5","2222593.07","[expenditure, material-supply]"
"1","24/9/2019 00:00:00+00","-550","2222043.07","[expenditure, material-supply]"
"1","24/9/2019 00:00:00+00","-124.78","2221918.29","[expenditure, material-supply]"
"1","24/9/2019 00:00:00+00","-142.8","2221775.49","[expenditure, material-supply]"
"1","24/9/2019 00:00:00+00","-24570","2197205.49","[expenditure, material-supply]"
"1","24/9/2019 00:00:00+00","-40.46","2197165.03","[expenditure, material-supply]"
"1","24/9/2019 00:00:00+00","-3082.17","2194082.86","[expenditure, material-supply]"
"1","24/9/2019 00:00:00+00","-3720","2190362.86","[expenditure, material-supply]"
"1","24/9/2019 00:00:00+00","-1513","2188849.86","[expenditure, material-supply]"
"1","24/9/2019 00:00:00+00","-1775.91","2187073.95","[expenditure, material-supply]"
"1","24/9/2019 00:00:00+00","-1149.59","2185924.36","[expenditure, material-supply]"
"1","24/9/2019 00:00:00+00","-2736.5","2183187.86","[expenditure, material-supply]"
"1","24/9/2019 00:00:00+00","-20500","2162687.86","[expenditure, material-supply]"
"1","24/9/2019 00:00:00+00","-2829.9","2159857.96","[expenditure, material-supply]"
"1","24/9/2019 00:00:00+00","-1729.57","2158128.39","[expenditure, material-supply]"
"1","24/9/2019 00:00:00+00","-1920","2156208.39","[expenditure, material-supply]"
"1","24/9/2019 00:00:00+00","-7939","2148269.39","[expenditure, material-supply]"
"1","24/9/2019 00:00:00+00","-3127.56","2145141.83","[expenditure, material-supply]"
"1","24/9/2019 00:00:00+00","-3622","2141519.83","[expenditure, material-supply]"
"1","24/9/2019 00:00:00+00","-0.36","2141519.47","[expenditure, material-supply]"
"1","24/9/2019 00:00:00+00","-82832.62","2058686.85","[expenditure]"
"1","24/9/2019 00:00:00+00","-156071.68","1902615.17","[expenditure]"
"1","24/9/2019 00:00:00+00","-42772.88","1859842.29","[expenditure, tax, salary-extra-costs, salary, material-supply]"
"1","24/9/2019 00:00:00+00","11714.8","1871557.09","[revenue]"
"1","24/9/2019 00:00:00+00","13800","1885357.09","[revenue]"
"1","24/9/2019 00:00:00+00","3030","1888387.09","[revenue, sales]"
"1","24/9/2019 00:00:00+00","2904.77","1891291.86","[revenue, sales]"
"1","24/9/2019 00:00:00+00","202.76","1891494.62","[revenue, sales]"
"1","24/9/2019 00:00:00+00","8614.07","1900108.69","[revenue, sales]"
"1","24/9/2019 00:00:00+00","750","1900858.69","[revenue, sales]"
"1","24/9/2019 00:00:00+00","1666.89","1902525.58","[revenue, chargeback, sales]"
"1","24/9/2019 00:00:00+00","-20.65","1902504.93","[expenditure]"
"1","24/9/2019 00:00:00+00","-19","1902485.93","[expenditure]"
"1","24/9/2019 00:00:00+00","-19","1902466.93","[expenditure]"
"1","24/9/2019 00:00:00+00","-19","1902447.93","[expenditure]"
"1","24/9/2019 00:00:00+00","-19","1397134.02","[expenditure]"
"1","24/9/2019 00:00:00+00","-19","1397115.02","[expenditure]"
"1","24/9/2019 00:00:00+00","-19","1397096.02","[expenditure]"
"1","24/9/2019 00:00:00+00","-19","1397077.02","[expenditure]"
"1","24/9/2019 00:00:00+00","-19","1902428.93","[expenditure]"
"1","24/9/2019 00:00:00+00","-19","1902409.93","[expenditure]"
"1","24/9/2019 00:00:00+00","-19","1902390.93","[expenditure]"
"1","24/9/2019 00:00:00+00","-19","1902371.93","[expenditure]"
"1","24/9/2019 00:00:00+00","-19","1902352.93","[expenditure]"
"1","24/9/2019 00:00:00+00","-19","1902333.93","[expenditure]"
"1","24/9/2019 00:00:00+00","-19","1902314.93","[expenditure]"
"1","24/9/2019 00:00:00+00","-19","1902295.93","[expenditure]"
"1","24/9/2019 00:00:00+00","-19","1902276.93","[expenditure]"
"1","24/9/2019 00:00:00+00","-19","1902257.93","[expenditure]"
"1","24/9/2019 00:00:00+00","-19","1902238.93","[expenditure]"
"1","24/9/2019 00:00:00+00","-19","1902219.93","[expenditure]"
"1","24/9/2019 00:00:00+00","-346.84","1901873.09","[expenditure, material-supply]"
"1","24/9/2019 00:00:00+00","-486.93","1901386.16","[expenditure, material-supply]"
"1","24/9/2019 00:00:00+00","-24.44","1901361.72","[expenditure]"
"1","24/9/2019 00:00:00+00","-1426.5","1899935.22","[expenditure]"
"1","25/9/2019 00:00:00+00","-2788.42","1897146.8","[expenditure, material-supply]"
"1","25/9/2019 00:00:00+00","-2177.5","1894969.3","[expenditure, material-supply]"
"1","25/9/2019 00:00:00+00","-5400","1889569.3","[expenditure, material-supply]"
"1","25/9/2019 00:00:00+00","-75","1889494.3","[expenditure, material-supply]"
"1","25/9/2019 00:00:00+00","-2886.63","1886607.67","[expenditure, material-supply]"
"1","25/9/2019 00:00:00+00","-8770","1877837.67","[expenditure, material-supply]"
"1","25/9/2019 00:00:00+00","-2707.93","1875129.74","[expenditure, material-supply]"
"1","25/9/2019 00:00:00+00","-7400","1867729.74","[expenditure, material-supply]"
"1","25/9/2019 00:00:00+00","-250","1867479.74","[expenditure, material-supply]"
"1","25/9/2019 00:00:00+00","-18600","1848879.74","[expenditure, material-supply]"
"1","25/9/2019 00:00:00+00","-1753.45","1847126.29","[expenditure, material-supply]"
"1","25/9/2019 00:00:00+00","-3541.26","1843585.03","[expenditure]"
"1","25/9/2019 00:00:00+00","-3230","1840355.03","[expenditure]"
"1","25/9/2019 00:00:00+00","-0.19","1397076.83","[expenditure, material-supply]"
"1","25/9/2019 00:00:00+00","-0.37","1397076.46","[expenditure, material-supply]"
"1","25/9/2019 00:00:00+00","4990","1402066.46","[revenue, sales]"
"1","25/9/2019 00:00:00+00","2680","1404746.46","[revenue]"
"1","25/9/2019 00:00:00+00","2190","1406936.46","[revenue]"
"1","25/9/2019 00:00:00+00","10240","1417176.46","[revenue, sales]"
"1","25/9/2019 00:00:00+00","100","1840455.03","[revenue, sales]"
"1","25/9/2019 00:00:00+00","5230","1845685.03","[revenue, sales]"
"1","25/9/2019 00:00:00+00","10832.17","1856517.2","[revenue, sales]"
"1","25/9/2019 00:00:00+00","13400","1869917.2","[revenue, sales]"
"1","25/9/2019 00:00:00+00","628.06","1870545.26","[revenue, chargeback, sales]"
"1","26/9/2019 00:00:00+00","-4455","1866090.26","[expenditure, material-supply]"
"1","26/9/2019 00:00:00+00","-1157.94","1864932.32","[expenditure, material-supply]"
"1","26/9/2019 00:00:00+00","-8330","1856602.32","[expenditure, material-supply]"
"1","26/9/2019 00:00:00+00","-7490","1849112.32","[expenditure, material-supply]"
"1","26/9/2019 00:00:00+00","-1347.91","1847764.41","[expenditure, material-supply]"
"1","26/9/2019 00:00:00+00","-1041.9","1846722.51","[expenditure, material-supply]"
"1","26/9/2019 00:00:00+00","-2480.6","1844241.91","[expenditure, material-supply]"
"1","26/9/2019 00:00:00+00","-1880.37","1842361.54","[expenditure, material-supply]"
"1","26/9/2019 00:00:00+00","-17064.29","1825297.25","[expenditure, material-supply]"
"1","26/9/2019 00:00:00+00","-0.17","1825297.08","[expenditure, material-supply]"
"1","26/9/2019 00:00:00+00","-1590.7","1823706.38","[expenditure, material-supply]"
"1","26/9/2019 00:00:00+00","-3600.85","1820105.53","[expenditure, material-supply]"
"1","26/9/2019 00:00:00+00","-4437.61","1815667.92","[expenditure, material-supply]"
"1","26/9/2019 00:00:00+00","-2726.59","1812941.33","[expenditure, material-supply]"
"1","26/9/2019 00:00:00+00","-2399.78","1810541.55","[expenditure, material-supply]"
"1","26/9/2019 00:00:00+00","-2373.1","1808168.45","[expenditure, material-supply]"
"1","26/9/2019 00:00:00+00","-1638.03","1806530.42","[expenditure, material-supply]"
"1","26/9/2019 00:00:00+00","-1486.31","1805044.11","[expenditure, material-supply]"
"1","26/9/2019 00:00:00+00","-433.16","1804610.95","[expenditure, material-supply]"
"1","26/9/2019 00:00:00+00","-9787.37","1794823.58","[expenditure, material-supply]"
"1","26/9/2019 00:00:00+00","-1088.56","1793735.02","[expenditure, material-supply]"
"1","26/9/2019 00:00:00+00","-4.32","1793730.7","[expenditure, material-supply]"
"1","26/9/2019 00:00:00+00","-98804.57","1694926.13","[expenditure, material-supply]"
"1","26/9/2019 00:00:00+00","-38539.42","1656386.71","[expenditure, material-supply]"
"1","26/9/2019 00:00:00+00","-1374.96","1655011.75","[expenditure, material-supply]"
"1","26/9/2019 00:00:00+00","-178.5","1654833.25","[expenditure, material-supply]"
"1","26/9/2019 00:00:00+00","-61.88","1654771.37","[expenditure, material-supply]"
"1","26/9/2019 00:00:00+00","-229.54","1654541.83","[expenditure, material-supply]"
"1","26/9/2019 00:00:00+00","-115.92","1654425.91","[expenditure, material-supply]"
"1","26/9/2019 00:00:00+00","-23.8","1654402.11","[expenditure, material-supply]"
"1","26/9/2019 00:00:00+00","-294.17","1654107.94","[expenditure, material-supply]"
"1","26/9/2019 00:00:00+00","-8991.29","1645116.65","[expenditure, material-supply]"
"1","26/9/2019 00:00:00+00","-6406.53","1638710.12","[expenditure, material-supply]"
"1","26/9/2019 00:00:00+00","-73440.39","1565269.73","[expenditure, material-supply]"
"1","26/9/2019 00:00:00+00","-24741.22","1540528.51","[expenditure, material-supply]"
"1","26/9/2019 00:00:00+00","-50.28","1540478.23","[expenditure, material-supply]"
"1","26/9/2019 00:00:00+00","-149.94","1540328.29","[expenditure, material-supply]"
"1","26/9/2019 00:00:00+00","-618.88","1539709.41","[expenditure, material-supply]"
"1","26/9/2019 00:00:00+00","-178.5","1539530.91","[expenditure, material-supply]"
"1","26/9/2019 00:00:00+00","-432.57","1539098.34","[expenditure, material-supply]"
"1","26/9/2019 00:00:00+00","-44.66","1539053.68","[expenditure, material-supply]"
"1","26/9/2019 00:00:00+00","-628.06","1538425.62","[expenditure, material-supply]"
"1","26/9/2019 00:00:00+00","110.81","1538536.43","[revenue]"
"1","26/9/2019 00:00:00+00","60000","1477176.46","[revenue, sales]"
"1","26/9/2019 00:00:00+00","-4.5","1477171.96","[expenditure, material-supply]"
"1","27/9/2019 00:00:00+00","-10600","1466571.96","[expenditure, material-supply]"
"1","27/9/2019 00:00:00+00","-945.97","1465625.99","[expenditure, material-supply]"
"1","27/9/2019 00:00:00+00","-1667.98","1536868.45","[expenditure, material-supply]"
"1","27/9/2019 00:00:00+00","-5700","1531168.45","[expenditure, material-supply]"
"1","27/9/2019 00:00:00+00","-5106.62","1526061.83","[expenditure, material-supply]"
"1","27/9/2019 00:00:00+00","-7250","1518811.83","[expenditure, material-supply]"
"1","27/9/2019 00:00:00+00","-1552.69","1517259.14","[expenditure, material-supply]"
"1","27/9/2019 00:00:00+00","-5500","1511759.14","[expenditure, material-supply]"
"1","27/9/2019 00:00:00+00","-5200","1506559.14","[expenditure, material-supply]"
"1","27/9/2019 00:00:00+00","-1255","1505304.14","[expenditure, material-supply]"
"1","27/9/2019 00:00:00+00","-7060","1498244.14","[expenditure, material-supply]"
"1","27/9/2019 00:00:00+00","-2160","1496084.14","[expenditure, material-supply]"
"1","27/9/2019 00:00:00+00","-3720","1492364.14","[expenditure, material-supply]"
"1","27/9/2019 00:00:00+00","-2320.11","1490044.03","[expenditure]"
"1","27/9/2019 00:00:00+00","-2997.97","1487046.06","[expenditure]"
"1","27/9/2019 00:00:00+00","50","1487096.06","[revenue]"
"1","27/9/2019 00:00:00+00","100","1487196.06","[revenue]"
"1","27/9/2019 00:00:00+00","1970","1489166.06","[revenue, sales]"
"1","27/9/2019 00:00:00+00","10150","1499316.06","[revenue, sales]"
"1","27/9/2019 00:00:00+00","512.3","1466138.29","[revenue]"
"1","27/9/2019 00:00:00+00","2210.97","1468349.26","[revenue, sales]"
"1","27/9/2019 00:00:00+00","23682.71","1492031.97","[revenue, sales]"
"1","27/9/2019 00:00:00+00","17064.29","1509096.26","[revenue, chargeback, sales]"
"1","27/9/2019 00:00:00+00","-4","1509092.26","[expenditure]"
"1","27/9/2019 00:00:00+00","-254.86","1508837.4","[expenditure, material-supply]"
"1","27/9/2019 00:00:00+00","-461.13","1508376.27","[expenditure, material-supply]"
"1","30/9/2019 00:00:00+00","-2507.79","1505868.48","[expenditure, material-supply]"
"1","30/9/2019 00:00:00+00","-3688","1502180.48","[expenditure, material-supply]"
"1","30/9/2019 00:00:00+00","-5844.67","1496335.81","[expenditure, material-supply]"
"1","30/9/2019 00:00:00+00","-2860","1493475.81","[expenditure, material-supply]"
"1","30/9/2019 00:00:00+00","-2529.45","1490946.36","[expenditure, material-supply]"
"1","30/9/2019 00:00:00+00","-6000","1484946.36","[expenditure, material-supply]"
"1","30/9/2019 00:00:00+00","-170.57","1499145.49","[expenditure]"
"1","30/9/2019 00:00:00+00","2600","1501745.49","[revenue, sales]"
"1","30/9/2019 00:00:00+00","1950","1486896.36","[revenue]"
"1","30/9/2019 00:00:00+00","2000","1488896.36","[revenue]"
"1","30/9/2019 00:00:00+00","100","1501845.49","[revenue]"
"1","30/9/2019 00:00:00+00","200","1502045.49","[revenue]"
"1","30/9/2019 00:00:00+00","8600","1510645.49","[revenue]"
"1","30/9/2019 00:00:00+00","2289.65","1512935.14","[revenue, sales]"
"1","30/9/2019 00:00:00+00","2477.31","1515412.45","[revenue, sales]"
"1","30/9/2019 00:00:00+00","1660","1517072.45","[revenue]"
"1","30/9/2019 00:00:00+00","100","1517172.45","[revenue]"
"1","30/9/2019 00:00:00+00","109.87","1517282.32","[revenue, sales]"
"1","30/9/2019 00:00:00+00","-4","1517278.32","[expenditure, credit-card]"
"1","30/9/2019 00:00:00+00","-78.62","1517199.7","[expenditure, material-supply]"
"1","30/9/2019 00:00:00+00","-28.78","1517170.92","[expenditure]"
"1","30/9/2019 00:00:00+00","4900","1522070.92","[revenue]"
"1","30/9/2019 00:00:00+00","-110.84","1521960.08","[expenditure]"
"1","1/10/2019 00:00:00+00","-1368.5","1520591.58","[expenditure, material-supply]"
"1","1/10/2019 00:00:00+00","-2568.06","1518023.52","[expenditure, material-supply]"
"1","1/10/2019 00:00:00+00","-48.62","1517974.9","[expenditure, material-supply]"
"1","1/10/2019 00:00:00+00","-184.45","1517790.45","[expenditure, material-supply]"
"1","1/10/2019 00:00:00+00","-127.45","1517663","[expenditure, material-supply]"
"1","1/10/2019 00:00:00+00","-29.75","1517633.25","[expenditure, material-supply]"
"1","1/10/2019 00:00:00+00","-1591.82","1516041.43","[expenditure, material-supply]"
"1","1/10/2019 00:00:00+00","-665.21","1515376.22","[expenditure, material-supply]"
"1","1/10/2019 00:00:00+00","-47.01","1515329.21","[expenditure, material-supply]"
"1","1/10/2019 00:00:00+00","-719.95","1514609.26","[expenditure, material-supply]"
"1","1/10/2019 00:00:00+00","-237.29","1514371.97","[expenditure, material-supply]"
"1","1/10/2019 00:00:00+00","-531.93","1513840.04","[expenditure, material-supply]"
"1","1/10/2019 00:00:00+00","-29.73","1513810.31","[expenditure, material-supply]"
"1","1/10/2019 00:00:00+00","-146.36","1513663.95","[expenditure, material-supply]"
"1","1/10/2019 00:00:00+00","-278.22","1513385.73","[expenditure, material-supply]"
"1","1/10/2019 00:00:00+00","-264.18","1513121.55","[expenditure, material-supply]"
"1","1/10/2019 00:00:00+00","-0.09","1513121.46","[expenditure, material-supply]"
"1","1/10/2019 00:00:00+00","-0.44","1513121.02","[expenditure, material-supply]"
"1","1/10/2019 00:00:00+00","-3285.45","1509835.57","[expenditure, rent]"
"1","1/10/2019 00:00:00+00","28.65","1509864.22","[revenue]"
"1","1/10/2019 00:00:00+00","28.88","1488925.24","[revenue]"
"1","1/10/2019 00:00:00+00","9.8","1488935.04","[revenue]"
"1","1/10/2019 00:00:00+00","16.31","1488951.35","[revenue]"
"1","1/10/2019 00:00:00+00","7.08","1488958.43","[revenue]"
"1","1/10/2019 00:00:00+00","15.18","1488973.61","[revenue]"
"1","1/10/2019 00:00:00+00","10490","1499463.61","[revenue]"
"1","1/10/2019 00:00:00+00","10570","1510033.61","[revenue]"
"1","1/10/2019 00:00:00+00","3680","1513713.61","[revenue]"
"1","1/10/2019 00:00:00+00","6010","1519723.61","[revenue]"
"1","1/10/2019 00:00:00+00","2520","1512384.22","[revenue]"
"1","1/10/2019 00:00:00+00","5990","1518374.22","[revenue]"
"1","1/10/2019 00:00:00+00","3910","1522284.22","[revenue]"
"1","1/10/2019 00:00:00+00","7310","1529594.22","[revenue, sales]"
"1","1/10/2019 00:00:00+00","3944.27","1533538.49","[revenue, sales]"
"1","1/10/2019 00:00:00+00","4360","1537898.49","[revenue, sales]"
"1","1/10/2019 00:00:00+00","9400","1547298.49","[revenue, sales]"
"1","1/10/2019 00:00:00+00","14982.44","1562280.93","[revenue, sales]"
"1","1/10/2019 00:00:00+00","-4","1562276.93","[expenditure]"
"1","1/10/2019 00:00:00+00","-1","1562275.93","[expenditure]"
"1","1/10/2019 00:00:00+00","-3","1562272.93","[expenditure]"
"1","1/10/2019 00:00:00+00","-91.15","1562181.78","[expenditure]"
"1","1/10/2019 00:00:00+00","-25.9","1562155.88","[expenditure]"
"1","2/10/2019 00:00:00+00","-4300","1515423.61","[expenditure, material-supply]"
"1","2/10/2019 00:00:00+00","-7636.17","1507787.44","[expenditure, material-supply]"
"1","2/10/2019 00:00:00+00","-7940","1499847.44","[expenditure, material-supply]"
"1","2/10/2019 00:00:00+00","-2240","1559915.88","[expenditure, material-supply]"
"1","2/10/2019 00:00:00+00","-1665","1558250.88","[expenditure, material-supply]"
"1","2/10/2019 00:00:00+00","-5979.8","1552271.08","[expenditure, material-supply]"
"1","2/10/2019 00:00:00+00","-4174.98","1495672.46","[expenditure, material-supply]"
"1","2/10/2019 00:00:00+00","-948.07","1494724.39","[expenditure, material-supply]"
"1","2/10/2019 00:00:00+00","-4500","1490224.39","[expenditure, material-supply]"
"1","2/10/2019 00:00:00+00","-860.2","1489364.19","[expenditure, material-supply]"
"1","2/10/2019 00:00:00+00","-2245.76","1487118.43","[expenditure, material-supply]"
"1","2/10/2019 00:00:00+00","-3600.04","1548671.04","[expenditure, material-supply]"
"1","2/10/2019 00:00:00+00","-2263.9","1546407.14","[expenditure, material-supply]"
"1","2/10/2019 00:00:00+00","-3210.26","1543196.88","[expenditure, material-supply]"
"1","2/10/2019 00:00:00+00","-11800","1531396.88","[expenditure, material-supply]"
"1","2/10/2019 00:00:00+00","-20170.7","1511226.18","[expenditure, material-supply]"
"1","2/10/2019 00:00:00+00","-11900","1499326.18","[expenditure]"
"1","2/10/2019 00:00:00+00","-123.85","1499202.33","[expenditure]"
"1","2/10/2019 00:00:00+00","-0.11","1499202.22","[expenditure, material-supply]"
"1","2/10/2019 00:00:00+00","-30","1499172.22","[expenditure, material-supply]"
"1","2/10/2019 00:00:00+00","-30","1499142.22","[expenditure]"
"1","2/10/2019 00:00:00+00","-18594.17","1480548.05","[expenditure]"
"1","2/10/2019 00:00:00+00","-3285.45","1477262.6","[expenditure]"
"1","2/10/2019 00:00:00+00","-1953.1","1475309.5","[expenditure, material-supply]"
"1","2/10/2019 00:00:00+00","-3461.35","1471848.15","[expenditure, material-supply]"
"1","2/10/2019 00:00:00+00","-3500.02","1468348.13","[expenditure, material-supply]"
"1","2/10/2019 00:00:00+00","-1917.5","1466430.63","[expenditure, material-supply]"
"1","2/10/2019 00:00:00+00","-18000","1448430.63","[expenditure, material-supply]"
"1","2/10/2019 00:00:00+00","-1300.6","1447130.03","[expenditure, material-supply]"
"1","2/10/2019 00:00:00+00","-6732.2","1440397.83","[expenditure, material-supply]"
"1","2/10/2019 00:00:00+00","-1792.2","1438605.63","[expenditure, material-supply]"
"1","2/10/2019 00:00:00+00","-3626.01","1434979.62","[expenditure, material-supply]"
"1","2/10/2019 00:00:00+00","1.59","1434981.21","[revenue, sales]"
"1","2/10/2019 00:00:00+00","2600","1437581.21","[revenue, sales]"
"1","2/10/2019 00:00:00+00","1812.52","1439393.73","[revenue, sales]"
"1","2/10/2019 00:00:00+00","100","1439493.73","[revenue, sales]"
"1","2/10/2019 00:00:00+00","5000","1444493.73","[revenue]"
"1","2/10/2019 00:00:00+00","-4","1444489.73","[expenditure]"
"1","2/10/2019 00:00:00+00","-7.85","1444481.88","[expenditure]"
"1","2/10/2019 00:00:00+00","-11.37","1444470.51","[expenditure]"
"1","2/10/2019 00:00:00+00","-24.33","1444446.18","[expenditure]"
"1","2/10/2019 00:00:00+00","-2750","1441696.18","[expenditure]"
"1","2/10/2019 00:00:00+00","-4390","1437306.18","[expenditure]"
"1","2/10/2019 00:00:00+00","-9080","1428226.18","[expenditure]"
"1","3/10/2019 00:00:00+00","11363.79","1439589.97","[revenue]"
"1","3/10/2019 00:00:00+00","6800.56","1446390.53","[revenue, sales]"
"1","3/10/2019 00:00:00+00","100","1446490.53","[revenue]"
"1","3/10/2019 00:00:00+00","100","1446590.53","[revenue, sales]"
"1","3/10/2019 00:00:00+00","4863.85","1451454.38","[revenue, sales]"
"1","3/10/2019 00:00:00+00","108.95","1451563.33","[revenue, sales]"
"1","3/10/2019 00:00:00+00","-4","1451559.33","[expenditure]"
"1","3/10/2019 00:00:00+00","-67.39","1487051.04","[expenditure]"
"1","4/10/2019 00:00:00+00","-173.62","1451385.71","[expenditure]"
"1","4/10/2019 00:00:00+00","-46.41","1451339.3","[expenditure, material-supply]"
"1","4/10/2019 00:00:00+00","-487.9","1450851.4","[expenditure, material-supply]"
"1","4/10/2019 00:00:00+00","-3384.36","1447467.04","[expenditure, material-supply]"
"1","4/10/2019 00:00:00+00","-260","1447207.04","[expenditure, material-supply]"
"1","4/10/2019 00:00:00+00","-139.79","1447067.25","[expenditure, material-supply]"
"1","4/10/2019 00:00:00+00","-270","1446797.25","[expenditure, material-supply]"
"1","4/10/2019 00:00:00+00","-160.65","1446636.6","[expenditure, material-supply]"
"1","4/10/2019 00:00:00+00","-284.41","1446352.19","[expenditure, material-supply]"
"1","4/10/2019 00:00:00+00","-340","1446012.19","[expenditure, material-supply]"
"1","4/10/2019 00:00:00+00","-1219.75","1444792.44","[expenditure, material-supply]"
"1","4/10/2019 00:00:00+00","-1386.9","1443405.54","[expenditure, material-supply]"
"1","4/10/2019 00:00:00+00","-3900.02","1439505.52","[expenditure, material-supply]"
"1","4/10/2019 00:00:00+00","-19568.21","1419937.31","[expenditure, material-supply]"
"1","4/10/2019 00:00:00+00","-1584.54","1418352.77","[expenditure, material-supply]"
"1","4/10/2019 00:00:00+00","-985.5","1417367.27","[expenditure, material-supply]"
"1","4/10/2019 00:00:00+00","-4050.12","1483000.92","[expenditure, material-supply]"
"1","4/10/2019 00:00:00+00","-4300","1478700.92","[expenditure, material-supply]"
"1","4/10/2019 00:00:00+00","-2634.14","1476066.78","[expenditure, material-supply]"
"1","4/10/2019 00:00:00+00","-3920.98","1472145.8","[expenditure, material-supply]"
"1","4/10/2019 00:00:00+00","-6130","1466015.8","[expenditure, material-supply]"
"1","4/10/2019 00:00:00+00","-11878","1405489.27","[expenditure, material-supply]"
"1","4/10/2019 00:00:00+00","-1737.07","1403752.2","[expenditure, material-supply]"
"1","4/10/2019 00:00:00+00","-4600","1399152.2","[expenditure, material-supply]"
"1","4/10/2019 00:00:00+00","-7293","1391859.2","[expenditure, material-supply]"
"1","4/10/2019 00:00:00+00","-1419.97","1390439.23","[expenditure, material-supply]"
"1","4/10/2019 00:00:00+00","-461.7","1389977.53","[expenditure, material-supply]"
"1","4/10/2019 00:00:00+00","-3276.8","1386700.73","[expenditure, material-supply]"
"1","4/10/2019 00:00:00+00","-6300","1380400.73","[expenditure, material-supply]"
"1","4/10/2019 00:00:00+00","-3658.92","1462356.88","[expenditure, material-supply]"
"1","4/10/2019 00:00:00+00","-3070","1459286.88","[expenditure, material-supply]"
"1","4/10/2019 00:00:00+00","-3750","1376650.73","[expenditure, material-supply]"
"1","4/10/2019 00:00:00+00","-0.07","1376650.66","[expenditure, material-supply]"
"1","4/10/2019 00:00:00+00","2050","1461336.88","[revenue, sales]"
"1","4/10/2019 00:00:00+00","50000","1511336.88","[revenue, sales]"
"1","4/10/2019 00:00:00+00","6000.12","1382650.78","[revenue, sales]"
"1","4/10/2019 00:00:00+00","1152.4","1383803.18","[revenue, sales]"
"1","4/10/2019 00:00:00+00","4752.48","1388555.66","[revenue, sales]"
"1","4/10/2019 00:00:00+00","10530","1399085.66","[revenue]"
"1","4/10/2019 00:00:00+00","2808.45","1401894.11","[revenue, sales]"
"1","4/10/2019 00:00:00+00","-22.8","1401871.31","[expenditure]"
"1","4/10/2019 00:00:00+00","-18","1401853.31","[expenditure]"
"1","4/10/2019 00:00:00+00","-19","1401834.31","[expenditure]"
"1","4/10/2019 00:00:00+00","-19","1511317.88","[expenditure]"
"1","4/10/2019 00:00:00+00","-19","1511298.88","[expenditure]"
"1","4/10/2019 00:00:00+00","-18","1511280.88","[expenditure]"
"1","4/10/2019 00:00:00+00","-19","1401815.31","[expenditure]"
"1","4/10/2019 00:00:00+00","-19","1401796.31","[expenditure]"
"1","4/10/2019 00:00:00+00","-19","1401777.31","[expenditure]"
"1","4/10/2019 00:00:00+00","-18","1401759.31","[expenditure]"
"1","4/10/2019 00:00:00+00","-19","1401740.31","[expenditure]"
"1","4/10/2019 00:00:00+00","-19","1401721.31","[expenditure]"
"1","4/10/2019 00:00:00+00","-19","1401702.31","[expenditure]"
"1","4/10/2019 00:00:00+00","-19","1401683.31","[expenditure]"
"1","4/10/2019 00:00:00+00","-19","1401664.31","[expenditure]"
"1","4/10/2019 00:00:00+00","-19","1401645.31","[expenditure]"
"1","4/10/2019 00:00:00+00","-19","1401626.31","[expenditure]"
"1","4/10/2019 00:00:00+00","-19","1401607.31","[expenditure]"
"1","4/10/2019 00:00:00+00","-19","1401588.31","[expenditure]"
"1","4/10/2019 00:00:00+00","-19","1401569.31","[expenditure]"
"1","4/10/2019 00:00:00+00","-19","1401550.31","[expenditure]"
"1","4/10/2019 00:00:00+00","-249.08","1401301.23","[leasing, expenditure, material-supply]"
"1","4/10/2019 00:00:00+00","-599.82","1400701.41","[expenditure, material-supply]"
"1","7/10/2019 00:00:00+00","-2172.6","1398528.81","[expenditure, material-supply]"
"1","7/10/2019 00:00:00+00","-4130","1394398.81","[expenditure, material-supply]"
"1","7/10/2019 00:00:00+00","-2141.97","1392256.84","[expenditure, material-supply]"
"1","7/10/2019 00:00:00+00","-4530","1387726.84","[expenditure, material-supply]"
"1","7/10/2019 00:00:00+00","-8260","1379466.84","[expenditure, material-supply]"
"1","7/10/2019 00:00:00+00","-1570","1377896.84","[expenditure, material-supply]"
"1","7/10/2019 00:00:00+00","-0.45","1377896.39","[expenditure, material-supply]"
"1","7/10/2019 00:00:00+00","-0.06","1377896.33","[expenditure, material-supply]"
"1","7/10/2019 00:00:00+00","-0.15","1377896.18","[expenditure, material-supply]"
"1","7/10/2019 00:00:00+00","-0.22","1377895.96","[expenditure, material-supply]"
"1","7/10/2019 00:00:00+00","-344","1377551.96","[expenditure]"
"1","7/10/2019 00:00:00+00","-458","1377093.96","[expenditure]"
"1","7/10/2019 00:00:00+00","9000","1386093.96","[revenue, sales]"
"1","7/10/2019 00:00:00+00","2250","1388343.96","[revenue]"
"1","7/10/2019 00:00:00+00","5000","1393343.96","[revenue]"
"1","7/10/2019 00:00:00+00","1847.66","1395191.62","[revenue, sales]"
"1","7/10/2019 00:00:00+00","7860","1403051.62","[revenue]"
"1","7/10/2019 00:00:00+00","13000","1416051.62","[revenue]"
"1","7/10/2019 00:00:00+00","6630","1422681.62","[revenue]"
"1","7/10/2019 00:00:00+00","11000","1433681.62","[revenue, sales]"
"1","7/10/2019 00:00:00+00","7600","1441281.62","[revenue, sales]"
"1","7/10/2019 00:00:00+00","40","1441321.62","[revenue, sales]"
"1","7/10/2019 00:00:00+00","-4","1441317.62","[expenditure, credit-card]"
"1","7/10/2019 00:00:00+00","65.15","1441382.77","[revenue]"
"1","7/10/2019 00:00:00+00","8350","1449732.77","[revenue]"
"1","8/10/2019 00:00:00+00","-907.5","1448825.27","[expenditure, material-supply]"
"1","8/10/2019 00:00:00+00","-4340","1506940.88","[expenditure, material-supply]"
"1","8/10/2019 00:00:00+00","-778.8","1506162.08","[expenditure, material-supply]"
"1","8/10/2019 00:00:00+00","-1009","1505153.08","[expenditure, material-supply]"
"1","8/10/2019 00:00:00+00","-1220","1503933.08","[expenditure, material-supply]"
"1","8/10/2019 00:00:00+00","-852.5","1503080.58","[expenditure, material-supply]"
"1","8/10/2019 00:00:00+00","-1095.01","1447730.26","[expenditure, material-supply]"
"1","8/10/2019 00:00:00+00","-1100","1446630.26","[expenditure, material-supply]"
"1","8/10/2019 00:00:00+00","-2423.52","1444206.74","[expenditure, material-supply]"
"1","8/10/2019 00:00:00+00","-1908.6","1442298.14","[expenditure, material-supply]"
"1","8/10/2019 00:00:00+00","-4700","1437598.14","[expenditure, material-supply]"
"1","8/10/2019 00:00:00+00","-99.22","1437498.92","[expenditure, material-supply]"
"1","8/10/2019 00:00:00+00","-230","1437268.92","[expenditure, material-supply]"
"1","8/10/2019 00:00:00+00","-40.1","1437228.82","[expenditure, material-supply]"
"1","8/10/2019 00:00:00+00","-12.19","1503068.39","[expenditure, material-supply]"
"1","8/10/2019 00:00:00+00","-236.81","1436992.01","[expenditure, material-supply]"
"1","8/10/2019 00:00:00+00","-479.21","1436512.8","[expenditure, material-supply]"
"1","8/10/2019 00:00:00+00","-821.1","1435691.7","[expenditure, material-supply]"
"1","8/10/2019 00:00:00+00","-2670.36","1433021.34","[expenditure, material-supply]"
"1","8/10/2019 00:00:00+00","-4570.05","1428451.29","[expenditure, material-supply]"
"1","8/10/2019 00:00:00+00","-30","1428421.29","[expenditure, material-supply]"
"1","8/10/2019 00:00:00+00","-6325.6","1422095.69","[expenditure, material-supply]"
"1","8/10/2019 00:00:00+00","-940.1","1421155.59","[expenditure, material-supply]"
"1","8/10/2019 00:00:00+00","-4944.43","1416211.16","[expenditure, material-supply]"
"1","8/10/2019 00:00:00+00","-1154.97","1415056.19","[expenditure, material-supply]"
"1","8/10/2019 00:00:00+00","-100","1414956.19","[expenditure, material-supply]"
"1","8/10/2019 00:00:00+00","60","1415016.19","[revenue]"
"1","8/10/2019 00:00:00+00","100","1415116.19","[revenue, sales]"
"1","8/10/2019 00:00:00+00","3300","1418416.19","[revenue]"
"1","8/10/2019 00:00:00+00","300","1418716.19","[revenue]"
"1","8/10/2019 00:00:00+00","3590","1422306.19","[revenue]"
"1","8/10/2019 00:00:00+00","5000.53","1427306.72","[revenue, sales]"
"1","8/10/2019 00:00:00+00","100","1427406.72","[revenue]"
"1","8/10/2019 00:00:00+00","30","1427436.72","[revenue, sales]"
"1","8/10/2019 00:00:00+00","3059.54","1430496.26","[revenue, sales]"
"1","8/10/2019 00:00:00+00","4650","1435146.26","[revenue, sales]"
"1","8/10/2019 00:00:00+00","12043.55","1447189.81","[revenue, sales]"
"1","8/10/2019 00:00:00+00","5321.24","1452511.05","[revenue, sales]"
"1","8/10/2019 00:00:00+00","3431.18","1455942.23","[revenue, sales]"
"1","8/10/2019 00:00:00+00","12430","1468372.23","[revenue]"
"1","8/10/2019 00:00:00+00","5725.33","1474097.56","[revenue, sales]"
"1","8/10/2019 00:00:00+00","3750","1477847.56","[revenue, chargeback, sales]"
"1","8/10/2019 00:00:00+00","-4","1477843.56","[expenditure]"
"1","8/10/2019 00:00:00+00","-4","1477839.56","[expenditure]"
"1","8/10/2019 00:00:00+00","-4","1477835.56","[expenditure]"
"1","8/10/2019 00:00:00+00","110.6","1477946.16","[revenue]"
"1","9/10/2019 00:00:00+00","-2715.8","1475230.36","[expenditure, material-supply]"
"1","9/10/2019 00:00:00+00","-665.7","1474564.66","[expenditure, material-supply]"
"1","9/10/2019 00:00:00+00","-2558.33","1500510.06","[expenditure, material-supply]"
"1","9/10/2019 00:00:00+00","-2141","1498369.06","[expenditure, material-supply]"
"1","9/10/2019 00:00:00+00","-1816.5","1496552.56","[expenditure, material-supply]"
"1","9/10/2019 00:00:00+00","-510.3","1496042.26","[expenditure, material-supply]"
"1","9/10/2019 00:00:00+00","-3110","1492932.26","[expenditure, material-supply]"
"1","9/10/2019 00:00:00+00","-2121.9","1490810.36","[expenditure, material-supply]"
"1","9/10/2019 00:00:00+00","-913.01","1489897.35","[expenditure, material-supply]"
"1","9/10/2019 00:00:00+00","-2240.4","1487656.95","[expenditure, material-supply]"
"1","9/10/2019 00:00:00+00","-7660","1479996.95","[expenditure, material-supply]"
"1","9/10/2019 00:00:00+00","-2121.51","1477875.44","[expenditure, material-supply]"
"1","9/10/2019 00:00:00+00","-729.9","1477145.54","[expenditure, material-supply]"
"1","9/10/2019 00:00:00+00","-20542.13","1456603.41","[expenditure, tax]"
"1","9/10/2019 00:00:00+00","30","1456633.41","[revenue]"
"1","9/10/2019 00:00:00+00","7000.14","1463633.55","[revenue, sales]"
"1","9/10/2019 00:00:00+00","1409.55","1475974.21","[revenue, sales]"
"1","9/10/2019 00:00:00+00","4080","1467713.55","[revenue, sales]"
"1","9/10/2019 00:00:00+00","5670.17","1481644.38","[revenue, sales]"
"1","9/10/2019 00:00:00+00","1744.04","1483388.42","[revenue, sales]"
"1","9/10/2019 00:00:00+00","1447.53","1484835.95","[revenue, sales]"
"1","9/10/2019 00:00:00+00","47.01","1467760.56","[revenue, sales]"
"1","9/10/2019 00:00:00+00","500","1468260.56","[revenue]"
"1","9/10/2019 00:00:00+00","100","1468360.56","[revenue]"
"1","9/10/2019 00:00:00+00","-4","1468356.56","[expenditure]"
"1","10/10/2019 00:00:00+00","-989.03","1467367.53","[expenditure, material-supply]"
"1","10/10/2019 00:00:00+00","-409.35","1484426.6","[expenditure, material-supply]"
"1","10/10/2019 00:00:00+00","-11.92","1484414.68","[expenditure, material-supply]"
"1","10/10/2019 00:00:00+00","-228.48","1484186.2","[expenditure, material-supply]"
"1","10/10/2019 00:00:00+00","-38.9","1484147.3","[expenditure, material-supply]"
"1","10/10/2019 00:00:00+00","-927.91","1483219.39","[expenditure, material-supply]"
"1","10/10/2019 00:00:00+00","-1340.83","1481878.56","[expenditure, material-supply]"
"1","10/10/2019 00:00:00+00","-595","1481283.56","[expenditure, material-supply]"
"1","10/10/2019 00:00:00+00","-187.06","1481096.5","[expenditure, material-supply]"
"1","10/10/2019 00:00:00+00","-236.11","1480860.39","[expenditure, material-supply]"
"1","10/10/2019 00:00:00+00","-114.49","1480745.9","[expenditure, material-supply]"
"1","10/10/2019 00:00:00+00","-3693.39","1477052.51","[expenditure, material-supply]"
"1","10/10/2019 00:00:00+00","-10.59","1477041.92","[expenditure, material-supply]"
"1","10/10/2019 00:00:00+00","-1135","1475906.92","[expenditure, material-supply]"
"1","10/10/2019 00:00:00+00","-2800","1473106.92","[expenditure, material-supply]"
"1","10/10/2019 00:00:00+00","-2974.63","1470132.29","[expenditure, material-supply]"
"1","10/10/2019 00:00:00+00","-20000","1450132.29","[expenditure, material-supply]"
"1","10/10/2019 00:00:00+00","-909","1449223.29","[expenditure, material-supply]"
"1","10/10/2019 00:00:00+00","-762.92","1448460.37","[expenditure, material-supply]"
"1","10/10/2019 00:00:00+00","-850","1466517.53","[expenditure, material-supply]"
"1","10/10/2019 00:00:00+00","-2770","1463747.53","[expenditure, material-supply]"
"1","10/10/2019 00:00:00+00","-2400","1461347.53","[expenditure, material-supply]"
"1","10/10/2019 00:00:00+00","-2019.3","1446441.07","[expenditure, material-supply]"
"1","10/10/2019 00:00:00+00","-4130","1442311.07","[expenditure, material-supply]"
"1","10/10/2019 00:00:00+00","-2116.4","1440194.67","[expenditure, material-supply]"
"1","10/10/2019 00:00:00+00","-996","1439198.67","[expenditure, material-supply]"
"1","10/10/2019 00:00:00+00","-9004.98","1430193.69","[expenditure, material-supply]"
"1","10/10/2019 00:00:00+00","-3429.39","1426764.3","[expenditure, material-supply]"
"1","10/10/2019 00:00:00+00","-3750","1423014.3","[expenditure, material-supply]"
"1","10/10/2019 00:00:00+00","-1171.14","1421843.16","[expenditure, salary, material-supply]"
"1","10/10/2019 00:00:00+00","-30","1421813.16","[expenditure, material-supply]"
"1","10/10/2019 00:00:00+00","-4501.01","1417312.15","[expenditure, material-supply]"
"1","10/10/2019 00:00:00+00","-861","1416451.15","[expenditure, material-supply]"
"1","10/10/2019 00:00:00+00","3343.68","1419794.83","[revenue]"
"1","10/10/2019 00:00:00+00","140","1419934.83","[revenue, sales]"
"1","10/10/2019 00:00:00+00","2761.96","1422696.79","[revenue, sales]"
"1","10/10/2019 00:00:00+00","1038.12","1423734.91","[revenue, sales]"
"1","10/10/2019 00:00:00+00","1580.98","1425315.89","[revenue, sales]"
"1","10/10/2019 00:00:00+00","140","1425455.89","[revenue, sales]"
"1","10/10/2019 00:00:00+00","4486.05","1429941.94","[revenue, sales]"
"1","10/10/2019 00:00:00+00","-3","1429938.94","[expenditure]"
"1","10/10/2019 00:00:00+00","-4","1429934.94","[expenditure]"
"1","10/10/2019 00:00:00+00","-4","1429930.94","[expenditure]"
"1","10/10/2019 00:00:00+00","-233.24","1429697.7","[expenditure, material-supply]"
"1","10/10/2019 00:00:00+00","-63.72","1429633.98","[expenditure]"
"1","11/10/2019 00:00:00+00","-2900.02","1426733.96","[expenditure, material-supply]"
"1","11/10/2019 00:00:00+00","-1678.3","1425055.66","[expenditure, material-supply]"
"1","11/10/2019 00:00:00+00","-1874.5","1423181.16","[expenditure, material-supply]"
"1","11/10/2019 00:00:00+00","-1939.5","1421241.66","[expenditure, material-supply]"
"1","11/10/2019 00:00:00+00","-2187.39","1459160.14","[expenditure, material-supply]"
"1","11/10/2019 00:00:00+00","-0.2","1421241.46","[expenditure, material-supply]"
"1","11/10/2019 00:00:00+00","-0.23","1421241.23","[expenditure, material-supply]"
"1","11/10/2019 00:00:00+00","30","1421271.23","[revenue]"
"1","11/10/2019 00:00:00+00","2000","1423271.23","[revenue, sales]"
"1","11/10/2019 00:00:00+00","100","1423371.23","[revenue]"
"1","11/10/2019 00:00:00+00","100","1423471.23","[revenue]"
"1","11/10/2019 00:00:00+00","100","1423571.23","[revenue, sales]"
"1","11/10/2019 00:00:00+00","3537.8","1427109.03","[revenue, sales]"
"1","11/10/2019 00:00:00+00","4450","1431559.03","[revenue, sales]"
"1","11/10/2019 00:00:00+00","3751","1435310.03","[revenue, sales]"
"1","11/10/2019 00:00:00+00","-20.2","1435289.83","[expenditure]"
"1","11/10/2019 00:00:00+00","-17.06","1435272.77","[expenditure]"
"1","11/10/2019 00:00:00+00","-13210.12","1422062.65","[expenditure, material-supply]"
"1","11/10/2019 00:00:00+00","-633.6","1421429.05","[expenditure, material-supply]"
"1","11/10/2019 00:00:00+00","-17064.29","1404364.76","[expenditure]"
"1","14/10/2019 00:00:00+00","-1400.9","1402963.86","[expenditure, material-supply]"
"1","14/10/2019 00:00:00+00","-1186.1","1401777.76","[expenditure, material-supply]"
"1","14/10/2019 00:00:00+00","-1092.01","1400685.75","[expenditure, material-supply]"
"1","14/10/2019 00:00:00+00","-5250","1395435.75","[expenditure, material-supply]"
"1","14/10/2019 00:00:00+00","-5080","1390355.75","[expenditure, material-supply]"
"1","14/10/2019 00:00:00+00","-2099.99","1388255.76","[expenditure, material-supply]"
"1","14/10/2019 00:00:00+00","-6620","1381635.76","[expenditure, material-supply]"
"1","14/10/2019 00:00:00+00","-5500","1376135.76","[expenditure, material-supply]"
"1","14/10/2019 00:00:00+00","-4310","1371825.76","[expenditure, material-supply]"
"1","14/10/2019 00:00:00+00","-809.8","1371015.96","[expenditure, material-supply]"
"1","14/10/2019 00:00:00+00","-10523","1360492.96","[expenditure, material-supply]"
"1","14/10/2019 00:00:00+00","-8386.97","1352105.99","[expenditure, material-supply]"
"1","14/10/2019 00:00:00+00","-8250","1343855.99","[expenditure, material-supply]"
"1","14/10/2019 00:00:00+00","-5440","1338415.99","[expenditure, material-supply]"
"1","14/10/2019 00:00:00+00","-2400","1336015.99","[expenditure, material-supply]"
"1","14/10/2019 00:00:00+00","-4200","1331815.99","[expenditure, material-supply]"
"1","14/10/2019 00:00:00+00","-3658.99","1328157","[expenditure, material-supply]"
"1","14/10/2019 00:00:00+00","-4500","1323657","[expenditure, material-supply]"
"1","14/10/2019 00:00:00+00","-1322.1","1322334.9","[expenditure, material-supply]"
"1","14/10/2019 00:00:00+00","-5100","1317234.9","[expenditure, material-supply]"
"1","14/10/2019 00:00:00+00","-1386.6","1315848.3","[expenditure, material-supply]"
"1","14/10/2019 00:00:00+00","-7030","1308818.3","[expenditure, material-supply]"
"1","14/10/2019 00:00:00+00","170","1308988.3","[revenue]"
"1","14/10/2019 00:00:00+00","17380","1476540.14","[revenue, sales]"
"1","14/10/2019 00:00:00+00","100","1476640.14","[revenue]"
"1","14/10/2019 00:00:00+00","30000","1506640.14","[revenue, sales]"
"1","14/10/2019 00:00:00+00","6790","1513430.14","[revenue, sales]"
"1","14/10/2019 00:00:00+00","3761.98","1517192.12","[revenue, sales]"
"1","14/10/2019 00:00:00+00","440","1517632.12","[revenue]"
"1","14/10/2019 00:00:00+00","9440","1527072.12","[revenue, sales]"
"1","14/10/2019 00:00:00+00","6610.36","1533682.48","[revenue, sales]"
"1","14/10/2019 00:00:00+00","5440","1539122.48","[revenue]"
"1","14/10/2019 00:00:00+00","6080","1315068.3","[revenue, sales]"
"1","14/10/2019 00:00:00+00","100","1315168.3","[revenue]"
"1","14/10/2019 00:00:00+00","-3","1315165.3","[expenditure]"
"1","14/10/2019 00:00:00+00","-4","1315161.3","[expenditure]"
"1","14/10/2019 00:00:00+00","-4","1315157.3","[expenditure, credit-card]"
"1","14/10/2019 00:00:00+00","-29","1315128.3","[expenditure]"
"1","14/10/2019 00:00:00+00","-19","1315109.3","[expenditure]"
"1","14/10/2019 00:00:00+00","-4","1315105.3","[expenditure]"
"1","14/10/2019 00:00:00+00","-19","1315086.3","[expenditure]"
"1","14/10/2019 00:00:00+00","-19","1315067.3","[expenditure]"
"1","14/10/2019 00:00:00+00","-19","1315048.3","[expenditure]"
"1","14/10/2019 00:00:00+00","-19","1315029.3","[expenditure]"
"1","14/10/2019 00:00:00+00","-19","1315010.3","[expenditure]"
"1","14/10/2019 00:00:00+00","-29.63","1314980.67","[expenditure]"
"1","14/10/2019 00:00:00+00","-19","1314961.67","[expenditure]"
"1","14/10/2019 00:00:00+00","-19","1314942.67","[expenditure]"
"1","14/10/2019 00:00:00+00","-19","1314923.67","[expenditure]"
"1","14/10/2019 00:00:00+00","-19","1314904.67","[expenditure]"
"1","14/10/2019 00:00:00+00","-19","1314885.67","[expenditure]"
"1","14/10/2019 00:00:00+00","-19","1314866.67","[expenditure]"
"1","14/10/2019 00:00:00+00","-19","1314847.67","[expenditure]"
"1","14/10/2019 00:00:00+00","-19","1314828.67","[expenditure]"
"1","14/10/2019 00:00:00+00","-19","1314809.67","[expenditure]"
"1","14/10/2019 00:00:00+00","-19","1314790.67","[expenditure]"
"1","14/10/2019 00:00:00+00","-19","1314771.67","[expenditure]"
"1","14/10/2019 00:00:00+00","-19","1314752.67","[expenditure]"
"1","14/10/2019 00:00:00+00","-19","1314733.67","[expenditure]"
"1","14/10/2019 00:00:00+00","-24999.92","1289733.75","[expenditure, material-supply]"
"1","14/10/2019 00:00:00+00","-8416.7","1281317.05","[expenditure]"
"1","15/10/2019 00:00:00+00","-3118.8","1278198.25","[expenditure, material-supply]"
"1","15/10/2019 00:00:00+00","-755.7","1277442.55","[expenditure, material-supply]"
"1","15/10/2019 00:00:00+00","-2150","1275292.55","[expenditure, material-supply]"
"1","15/10/2019 00:00:00+00","-778","1274514.55","[expenditure, material-supply]"
"1","15/10/2019 00:00:00+00","-1573.5","1272941.05","[expenditure, material-supply]"
"1","15/10/2019 00:00:00+00","-6680","1266261.05","[expenditure, material-supply]"
"1","15/10/2019 00:00:00+00","-11979.29","1254281.76","[expenditure, material-supply]"
"1","15/10/2019 00:00:00+00","-7300","1246981.76","[expenditure, material-supply]"
"1","15/10/2019 00:00:00+00","-6180","1240801.76","[expenditure, material-supply]"
"1","15/10/2019 00:00:00+00","-693","1240108.76","[expenditure, material-supply]"
"1","15/10/2019 00:00:00+00","-1017.5","1239091.26","[expenditure, material-supply]"
"1","15/10/2019 00:00:00+00","-62.74","1239028.52","[expenditure, material-supply]"
"1","15/10/2019 00:00:00+00","-977.59","1238050.93","[expenditure, material-supply]"
"1","15/10/2019 00:00:00+00","-743.51","1237307.42","[expenditure, material-supply]"
"1","15/10/2019 00:00:00+00","-8092","1229215.42","[expenditure, material-supply]"
"1","15/10/2019 00:00:00+00","-154.57","1229060.85","[expenditure, material-supply]"
"1","15/10/2019 00:00:00+00","-321.97","1538800.51","[expenditure, administration, material-supply]"
"1","15/10/2019 00:00:00+00","-139.7","1538660.81","[expenditure, material-supply]"
"1","15/10/2019 00:00:00+00","-140","1538520.81","[expenditure, material-supply]"
"1","15/10/2019 00:00:00+00","-280","1538240.81","[expenditure, material-supply]"
"1","15/10/2019 00:00:00+00","-41","1538199.81","[expenditure, material-supply]"
"1","15/10/2019 00:00:00+00","-0.15","1538199.66","[expenditure, material-supply]"
"1","15/10/2019 00:00:00+00","-0.06","1538199.6","[expenditure, material-supply]"
"1","15/10/2019 00:00:00+00","100","1538299.6","[revenue]"
"1","15/10/2019 00:00:00+00","100","1538399.6","[revenue, sales]"
"1","15/10/2019 00:00:00+00","1314.31","1539713.91","[revenue, sales]"
"1","15/10/2019 00:00:00+00","2181","1231241.85","[revenue, sales]"
"1","15/10/2019 00:00:00+00","2314.33","1233556.18","[revenue, sales]"
"1","15/10/2019 00:00:00+00","4847.72","1238403.9","[revenue, sales]"
"1","15/10/2019 00:00:00+00","17319.15","1255723.05","[revenue, sales]"
"1","15/10/2019 00:00:00+00","0.53","1255723.58","[revenue, sales]"
"1","15/10/2019 00:00:00+00","1620","1257343.58","[revenue]"
"1","15/10/2019 00:00:00+00","100","1257443.58","[revenue]"
"1","15/10/2019 00:00:00+00","100","1257543.58","[revenue]"
"1","15/10/2019 00:00:00+00","33626.18","1291169.76","[revenue, sales]"
"1","15/10/2019 00:00:00+00","-13.38","1291156.38","[expenditure]"
"1","15/10/2019 00:00:00+00","-19","1291137.38","[expenditure]"
"1","15/10/2019 00:00:00+00","-19","1291118.38","[expenditure]"
"1","15/10/2019 00:00:00+00","-19","1291099.38","[expenditure]"
"1","15/10/2019 00:00:00+00","-19","1291080.38","[expenditure]"
"1","15/10/2019 00:00:00+00","-19","1291061.38","[expenditure]"
"1","15/10/2019 00:00:00+00","-19","1291042.38","[expenditure]"
"1","15/10/2019 00:00:00+00","-29","1291013.38","[expenditure]"
"1","15/10/2019 00:00:00+00","-1154.78","1289858.6","[expenditure, administration, material-supply]"
"1","15/10/2019 00:00:00+00","-25123.37","1264735.23","[expenditure, credit-card, credit, material-supply]"
"1","15/10/2019 00:00:00+00","-4310","1260425.23","[expenditure]"
"1","16/10/2019 00:00:00+00","-4050","1256375.23","[expenditure, material-supply]"
"1","16/10/2019 00:00:00+00","-724.5","1538989.41","[expenditure, material-supply]"
"1","16/10/2019 00:00:00+00","-2991.6","1535997.81","[expenditure, material-supply]"
"1","16/10/2019 00:00:00+00","-4369.16","1531628.65","[expenditure, material-supply]"
"1","16/10/2019 00:00:00+00","-1105","1530523.65","[expenditure, material-supply]"
"1","16/10/2019 00:00:00+00","-10300","1520223.65","[expenditure, material-supply]"
"1","16/10/2019 00:00:00+00","-1344.5","1255030.73","[expenditure, material-supply]"
"1","16/10/2019 00:00:00+00","-4110","1250920.73","[expenditure, material-supply]"
"1","16/10/2019 00:00:00+00","-2500","1248420.73","[expenditure, material-supply]"
"1","16/10/2019 00:00:00+00","-26.9","1248393.83","[expenditure]"
"1","16/10/2019 00:00:00+00","7976.26","1256370.09","[revenue, sales]"
"1","16/10/2019 00:00:00+00","100","1256470.09","[revenue, sales]"
"1","16/10/2019 00:00:00+00","100","1256570.09","[revenue]"
"1","16/10/2019 00:00:00+00","5340","1261910.09","[revenue]"
"1","16/10/2019 00:00:00+00","4942.96","1266853.05","[revenue, sales]"
"1","16/10/2019 00:00:00+00","3450","1270303.05","[revenue, sales]"
"1","16/10/2019 00:00:00+00","2524.49","1272827.54","[revenue, sales]"
"1","16/10/2019 00:00:00+00","1810.19","1274637.73","[revenue, sales]"
"1","16/10/2019 00:00:00+00","1764.05","1276401.78","[revenue, sales]"
"1","16/10/2019 00:00:00+00","2350","1278751.78","[revenue]"
"1","16/10/2019 00:00:00+00","-4","1278747.78","[expenditure, credit-card]"
"1","16/10/2019 00:00:00+00","-34.64","1278713.14","[expenditure]"
"1","16/10/2019 00:00:00+00","-28.65","1278684.49","[expenditure]"
"1","16/10/2019 00:00:00+00","17064.29","1295748.78","[revenue]"
"1","17/10/2019 00:00:00+00","-4650","1291098.78","[expenditure, material-supply]"
"1","17/10/2019 00:00:00+00","-0.16","1291098.62","[expenditure, material-supply]"
"1","17/10/2019 00:00:00+00","-2250","1288848.62","[expenditure, material-supply]"
"1","17/10/2019 00:00:00+00","-17145.61","1271703.01","[expenditure, material-supply]"
"1","17/10/2019 00:00:00+00","-12300","1259403.01","[expenditure, material-supply]"
"1","17/10/2019 00:00:00+00","-2781","1256622.01","[expenditure, material-supply]"
"1","17/10/2019 00:00:00+00","-825.5","1255796.51","[expenditure, material-supply]"
"1","17/10/2019 00:00:00+00","-3800","1251996.51","[expenditure, material-supply]"
"1","17/10/2019 00:00:00+00","-6600","1245396.51","[expenditure, material-supply]"
"1","17/10/2019 00:00:00+00","-3500","1241896.51","[expenditure, material-supply]"
"1","17/10/2019 00:00:00+00","-500","1241396.51","[expenditure, material-supply]"
"1","17/10/2019 00:00:00+00","-1939.39","1239457.12","[expenditure, material-supply]"
"1","17/10/2019 00:00:00+00","-6600","1232857.12","[expenditure, material-supply]"
"1","17/10/2019 00:00:00+00","-1752","1231105.12","[expenditure, material-supply]"
"1","17/10/2019 00:00:00+00","-4100","1227005.12","[expenditure, material-supply]"
"1","17/10/2019 00:00:00+00","-14300","1212705.12","[expenditure, material-supply]"
"1","17/10/2019 00:00:00+00","-3965.31","1208739.81","[expenditure, material-supply]"
"1","17/10/2019 00:00:00+00","-12562.35","1196177.46","[expenditure, material-supply]"
"1","17/10/2019 00:00:00+00","-2902","1193275.46","[expenditure, material-supply]"
"1","17/10/2019 00:00:00+00","-267.26","1193008.2","[expenditure, material-supply]"
"1","17/10/2019 00:00:00+00","-297.5","1192710.7","[expenditure, material-supply]"
"1","17/10/2019 00:00:00+00","-19.85","1192690.85","[expenditure, material-supply]"
"1","17/10/2019 00:00:00+00","-315","1192375.85","[expenditure]"
"1","17/10/2019 00:00:00+00","3457.21","1195833.06","[revenue, sales]"
"1","17/10/2019 00:00:00+00","1742.89","1197575.95","[revenue, sales]"
"1","17/10/2019 00:00:00+00","1380.98","1198956.93","[revenue, sales]"
"1","17/10/2019 00:00:00+00","2371.48","1201328.41","[revenue, sales]"
"1","17/10/2019 00:00:00+00","3504.83","1204833.24","[revenue, sales]"
"1","17/10/2019 00:00:00+00","50","1204883.24","[revenue]"
"1","17/10/2019 00:00:00+00","100","1204983.24","[revenue]"
"1","17/10/2019 00:00:00+00","3650","1208633.24","[revenue, sales]"
"1","17/10/2019 00:00:00+00","100","1520323.65","[revenue, sales]"
"1","17/10/2019 00:00:00+00","100","1520423.65","[revenue]"
"1","17/10/2019 00:00:00+00","85","1520508.65","[revenue, sales]"
"1","17/10/2019 00:00:00+00","-6050","1514458.65","[expenditure, material-supply]"
"1","17/10/2019 00:00:00+00","-3435","1511023.65","[expenditure, material-supply]"
"1","17/10/2019 00:00:00+00","112.29","1511135.94","[revenue]"
"1","17/10/2019 00:00:00+00","-4","1511131.94","[expenditure, material-supply]"
"1","17/10/2019 00:00:00+00","-4","1511127.94","[expenditure, material-supply]"
"1","18/10/2019 00:00:00+00","-0.12","1511127.82","[expenditure, material-supply]"
"1","18/10/2019 00:00:00+00","-0.06","1511127.76","[expenditure, material-supply]"
"1","18/10/2019 00:00:00+00","-2349.99","1508777.77","[expenditure, material-supply]"
"1","18/10/2019 00:00:00+00","-5053.5","1503724.27","[expenditure, material-supply]"
"1","18/10/2019 00:00:00+00","-2390.9","1501333.37","[expenditure, material-supply]"
"1","18/10/2019 00:00:00+00","-7850","1493483.37","[expenditure, material-supply]"
"1","18/10/2019 00:00:00+00","-14270","1479213.37","[expenditure, material-supply]"
"1","18/10/2019 00:00:00+00","-6086.96","1202546.28","[expenditure, material-supply]"
"1","18/10/2019 00:00:00+00","-85","1202461.28","[expenditure, material-supply]"
"1","18/10/2019 00:00:00+00","-1907","1200554.28","[expenditure, material-supply]"
"1","18/10/2019 00:00:00+00","-664","1199890.28","[expenditure, material-supply]"
"1","18/10/2019 00:00:00+00","-6080","1193810.28","[expenditure, material-supply]"
"1","18/10/2019 00:00:00+00","-2092.2","1191718.08","[expenditure, material-supply]"
"1","18/10/2019 00:00:00+00","-739.55","1190978.53","[expenditure, material-supply]"
"1","18/10/2019 00:00:00+00","-660","1190318.53","[expenditure, material-supply]"
"1","18/10/2019 00:00:00+00","-1114.5","1189204.03","[expenditure, material-supply]"
"1","18/10/2019 00:00:00+00","-15","1189189.03","[expenditure]"
"1","18/10/2019 00:00:00+00","-86.44","1189102.59","[expenditure]"
"1","18/10/2019 00:00:00+00","100","1189202.59","[revenue]"
"1","18/10/2019 00:00:00+00","6090","1485303.37","[revenue]"
"1","18/10/2019 00:00:00+00","110","1485413.37","[revenue]"
"1","18/10/2019 00:00:00+00","1190.5","1486603.87","[revenue, sales]"
"1","18/10/2019 00:00:00+00","1695.27","1190897.86","[revenue, sales]"
"1","18/10/2019 00:00:00+00","1419.08","1192316.94","[revenue, sales]"
"1","18/10/2019 00:00:00+00","100","1486703.87","[revenue, sales]"
"1","18/10/2019 00:00:00+00","1550.82","1488254.69","[revenue, sales]"
"1","18/10/2019 00:00:00+00","12842.7","1205159.64","[revenue, sales]"
"1","18/10/2019 00:00:00+00","2273.3","1207432.94","[revenue, sales]"
"1","18/10/2019 00:00:00+00","11849.77","1219282.71","[revenue, sales]"
"1","18/10/2019 00:00:00+00","0.4","1219283.11","[revenue, sales]"
"1","18/10/2019 00:00:00+00","0.1","1219283.21","[revenue, sales]"
"1","18/10/2019 00:00:00+00","0.54","1219283.75","[revenue, sales]"
"1","18/10/2019 00:00:00+00","1760","1221043.75","[revenue]"
"1","18/10/2019 00:00:00+00","5850","1226893.75","[revenue]"
"1","18/10/2019 00:00:00+00","100","1226993.75","[revenue]"
"1","18/10/2019 00:00:00+00","30","1227023.75","[revenue]"
"1","18/10/2019 00:00:00+00","4905.49","1231929.24","[revenue, sales]"
"1","18/10/2019 00:00:00+00","-4","1231925.24","[expenditure]"
"1","18/10/2019 00:00:00+00","-547.19","1231378.05","[expenditure, material-supply]"
"1","18/10/2019 00:00:00+00","-2.66","1231375.39","[expenditure]"
"1","18/10/2019 00:00:00+00","-1.73","1231373.66","[expenditure]"
"1","21/10/2019 00:00:00+00","-0.2","1231373.46","[expenditure, material-supply]"
"1","21/10/2019 00:00:00+00","40000","1271373.46","[revenue, sales]"
"1","21/10/2019 00:00:00+00","3228.64","1274602.1","[revenue, sales]"
"1","21/10/2019 00:00:00+00","4840","1493094.69","[revenue]"
"1","21/10/2019 00:00:00+00","100","1493194.69","[revenue, sales]"
"1","21/10/2019 00:00:00+00","3600","1496794.69","[revenue, sales]"
"1","21/10/2019 00:00:00+00","14130","1510924.69","[revenue, sales]"
"1","21/10/2019 00:00:00+00","2500","1513424.69","[revenue]"
"1","21/10/2019 00:00:00+00","4010","1517434.69","[revenue]"
"1","21/10/2019 00:00:00+00","7500","1524934.69","[revenue]"
"1","21/10/2019 00:00:00+00","8300","1533234.69","[revenue]"
"1","21/10/2019 00:00:00+00","85","1274687.1","[revenue, sales]"
"1","21/10/2019 00:00:00+00","2200","1276887.1","[revenue]"
"1","21/10/2019 00:00:00+00","100","1276987.1","[revenue]"
"1","21/10/2019 00:00:00+00","-24.43","1276962.67","[expenditure, credit-card]"
"1","21/10/2019 00:00:00+00","-57","1276905.67","[expenditure, material-supply]"
"1","21/10/2019 00:00:00+00","-147.6","1276758.07","[expenditure]"
"1","21/10/2019 00:00:00+00","-3","1276755.07","[expenditure]"
"1","22/10/2019 00:00:00+00","-2650.49","1274104.58","[expenditure, material-supply]"
"1","22/10/2019 00:00:00+00","-5020.52","1528214.17","[expenditure, material-supply]"
"1","22/10/2019 00:00:00+00","-1236.9","1526977.27","[expenditure, material-supply]"
"1","22/10/2019 00:00:00+00","-25500","1501477.27","[expenditure, material-supply]"
"1","22/10/2019 00:00:00+00","-8440","1493037.27","[expenditure, material-supply]"
"1","22/10/2019 00:00:00+00","-621","1273483.58","[expenditure, material-supply]"
"1","22/10/2019 00:00:00+00","-9000","1264483.58","[expenditure, material-supply]"
"1","22/10/2019 00:00:00+00","-1891.5","1262592.08","[expenditure, material-supply]"
"1","22/10/2019 00:00:00+00","-1338.5","1261253.58","[expenditure, material-supply]"
"1","22/10/2019 00:00:00+00","-5612.8","1255640.78","[expenditure, material-supply]"
"1","22/10/2019 00:00:00+00","-1962","1253678.78","[expenditure, material-supply]"
"1","22/10/2019 00:00:00+00","-5446.18","1248232.6","[expenditure, material-supply]"
"1","22/10/2019 00:00:00+00","-8.81","1248223.79","[expenditure, material-supply]"
"1","22/10/2019 00:00:00+00","-89.36","1248134.43","[expenditure, material-supply]"
"1","22/10/2019 00:00:00+00","-538.59","1247595.84","[expenditure, material-supply]"
"1","22/10/2019 00:00:00+00","-130.66","1492906.61","[expenditure, material-supply]"
"1","22/10/2019 00:00:00+00","-126.02","1492780.59","[expenditure, material-supply]"
"1","22/10/2019 00:00:00+00","-178.5","1492602.09","[expenditure, material-supply]"
"1","22/10/2019 00:00:00+00","-79.61","1492522.48","[expenditure, material-supply]"
"1","22/10/2019 00:00:00+00","-49.66","1492472.82","[expenditure, material-supply]"
"1","22/10/2019 00:00:00+00","-306.43","1492166.39","[expenditure, material-supply]"
"1","22/10/2019 00:00:00+00","-0.36","1492166.03","[expenditure, material-supply]"
"1","22/10/2019 00:00:00+00","-0.13","1247595.71","[expenditure, material-supply]"
"1","22/10/2019 00:00:00+00","-2619.55","1244976.16","[expenditure]"
"1","22/10/2019 00:00:00+00","-1339.51","1243636.65","[expenditure, material-supply]"
"1","22/10/2019 00:00:00+00","-1106.07","1242530.58","[expenditure, material-supply]"
"1","22/10/2019 00:00:00+00","-1297.5","1241233.08","[expenditure, material-supply]"
"1","22/10/2019 00:00:00+00","-418.49","1240814.59","[expenditure, material-supply]"
"1","22/10/2019 00:00:00+00","-10860","1481306.03","[expenditure, material-supply]"
"1","22/10/2019 00:00:00+00","1503.98","1482810.01","[revenue, sales]"
"1","22/10/2019 00:00:00+00","8400","1491210.01","[revenue]"
"1","22/10/2019 00:00:00+00","5500","1496710.01","[revenue]"
"1","22/10/2019 00:00:00+00","6266.14","1247080.73","[revenue, sales]"
"1","22/10/2019 00:00:00+00","6819.9","1253900.63","[revenue, sales]"
"1","22/10/2019 00:00:00+00","3715.59","1257616.22","[revenue, sales]"
"1","22/10/2019 00:00:00+00","-13.86","1257602.36","[expenditure]"
"1","22/10/2019 00:00:00+00","-320","1257282.36","[expenditure, credit, material-supply]"
"1","22/10/2019 00:00:00+00","-10","1257272.36","[expenditure, credit, material-supply]"
"1","22/10/2019 00:00:00+00","-10","1257262.36","[expenditure, credit, material-supply]"
"1","22/10/2019 00:00:00+00","-10","1257252.36","[expenditure, administration, credit, material-supply]"
"1","22/10/2019 00:00:00+00","-10","1257242.36","[expenditure, administration, credit, material-supply]"
"1","22/10/2019 00:00:00+00","-75","1257167.36","[expenditure, credit, material-supply]"
"1","22/10/2019 00:00:00+00","-87.5","1257079.86","[expenditure, credit, material-supply]"
"1","22/10/2019 00:00:00+00","-40","1257039.86","[expenditure, credit, material-supply]"
"1","22/10/2019 00:00:00+00","-120","1256919.86","[expenditure, credit, material-supply]"
"1","22/10/2019 00:00:00+00","-95.2","1256824.66","[expenditure, credit, material-supply]"
"1","22/10/2019 00:00:00+00","2493.24","1259317.9","[revenue]"
"1","23/10/2019 00:00:00+00","-3721","1255596.9","[expenditure, material-supply]"
"1","23/10/2019 00:00:00+00","-2904.77","1493805.24","[expenditure, material-supply]"
"1","23/10/2019 00:00:00+00","-1211.92","1492593.32","[expenditure, material-supply]"
"1","23/10/2019 00:00:00+00","-1744.04","1490849.28","[expenditure, material-supply]"
"1","23/10/2019 00:00:00+00","-525","1490324.28","[expenditure, material-supply]"
"1","23/10/2019 00:00:00+00","-1728.7","1488595.58","[expenditure, material-supply]"
"1","23/10/2019 00:00:00+00","-7049.96","1248546.94","[expenditure, material-supply]"
"1","23/10/2019 00:00:00+00","-818","1247728.94","[expenditure, material-supply]"
"1","23/10/2019 00:00:00+00","-681","1247047.94","[expenditure, material-supply]"
"1","23/10/2019 00:00:00+00","-169550.26","1077497.68","[expenditure]"
"1","23/10/2019 00:00:00+00","-91441.14","986056.54","[expenditure]"
"1","23/10/2019 00:00:00+00","-0.43","986056.11","[expenditure, material-supply]"
"1","23/10/2019 00:00:00+00","-0.46","986055.65","[expenditure, material-supply]"
"1","23/10/2019 00:00:00+00","-46689.84","939365.81","[expenditure, tax, salary-extra-costs, salary, material-supply]"
"1","23/10/2019 00:00:00+00","3730","943095.81","[revenue]"
"1","23/10/2019 00:00:00+00","4009.6","947105.41","[revenue, sales]"
"1","23/10/2019 00:00:00+00","5914.4","953019.81","[revenue, sales]"
"1","23/10/2019 00:00:00+00","2571.48","955591.29","[revenue, sales]"
"1","23/10/2019 00:00:00+00","1847.66","957438.95","[revenue, sales]"
"1","23/10/2019 00:00:00+00","8630.22","966069.17","[revenue, sales]"
"1","23/10/2019 00:00:00+00","13800","979869.17","[revenue]"
"1","23/10/2019 00:00:00+00","1510","981379.17","[revenue]"
"1","23/10/2019 00:00:00+00","5000","986379.17","[revenue]"
"1","23/10/2019 00:00:00+00","-45.22","986333.95","[expenditure, material-supply, cash]"
"1","24/10/2019 00:00:00+00","-2998.2","1485597.38","[expenditure, material-supply]"
"1","24/10/2019 00:00:00+00","-4125.9","982208.05","[expenditure, material-supply]"
"1","24/10/2019 00:00:00+00","-4602.99","977605.06","[expenditure, material-supply]"
"1","24/10/2019 00:00:00+00","-880.1","976724.96","[expenditure, material-supply]"
"1","24/10/2019 00:00:00+00","-920","975804.96","[expenditure, material-supply]"
"1","24/10/2019 00:00:00+00","-1158","974646.96","[expenditure, material-supply]"
"1","24/10/2019 00:00:00+00","-300","974346.96","[expenditure, material-supply]"
"1","24/10/2019 00:00:00+00","-244.18","974102.78","[expenditure, material-supply]"
"1","24/10/2019 00:00:00+00","-834.37","973268.41","[expenditure, material-supply]"
"1","24/10/2019 00:00:00+00","-4978.37","968290.04","[expenditure, law, tax, material-supply]"
"1","24/10/2019 00:00:00+00","-58.08","968231.96","[expenditure, material-supply]"
"1","24/10/2019 00:00:00+00","-3903.2","964328.76","[expenditure, material-supply]"
"1","24/10/2019 00:00:00+00","-1092.42","1484504.96","[expenditure, material-supply]"
"1","24/10/2019 00:00:00+00","-1016.79","1483488.17","[expenditure, material-supply]"
"1","24/10/2019 00:00:00+00","-261.8","1483226.37","[expenditure, material-supply]"
"1","24/10/2019 00:00:00+00","-1554.47","1481671.9","[expenditure]"
"1","24/10/2019 00:00:00+00","-0.26","1481671.64","[expenditure, material-supply]"
"1","24/10/2019 00:00:00+00","4857.24","969186","[revenue, sales]"
"1","24/10/2019 00:00:00+00","85","969271","[revenue, sales]"
"1","24/10/2019 00:00:00+00","16600","985871","[revenue]"
"1","24/10/2019 00:00:00+00","1172.81","987043.81","[revenue, sales]"
"1","24/10/2019 00:00:00+00","8850","995893.81","[revenue, sales]"
"1","24/10/2019 00:00:00+00","3351.66","999245.47","[revenue, sales]"
"1","24/10/2019 00:00:00+00","2277.76","1001523.23","[revenue, sales]"
"1","24/10/2019 00:00:00+00","6080","1007603.23","[revenue, sales]"
"1","24/10/2019 00:00:00+00","100","1007703.23","[revenue]"
"1","24/10/2019 00:00:00+00","3300","1011003.23","[revenue]"
"1","24/10/2019 00:00:00+00","1080","1012083.23","[revenue]"
"1","24/10/2019 00:00:00+00","50","1012133.23","[revenue]"
"1","24/10/2019 00:00:00+00","6452.31","1018585.54","[revenue, sales]"
"1","24/10/2019 00:00:00+00","-4","1018581.54","[expenditure]"
"1","24/10/2019 00:00:00+00","-4","1018577.54","[expenditure]"
"1","24/10/2019 00:00:00+00","-4.5","1018573.04","[expenditure, material-supply]"
"1","24/10/2019 00:00:00+00","112.19","1018685.23","[revenue]"
"1","24/10/2019 00:00:00+00","114.42","1018799.65","[revenue]"
"1","25/10/2019 00:00:00+00","-2528.94","1016270.71","[expenditure, material-supply]"
"1","25/10/2019 00:00:00+00","-2711","1013559.71","[expenditure, material-supply]"
"1","25/10/2019 00:00:00+00","-4165","1009394.71","[expenditure, material-supply]"
"1","25/10/2019 00:00:00+00","-8941.7","1000453.01","[expenditure, material-supply]"
"1","25/10/2019 00:00:00+00","-2294.7","998158.31","[expenditure, material-supply]"
"1","25/10/2019 00:00:00+00","-1606","996552.31","[expenditure, material-supply]"
"1","25/10/2019 00:00:00+00","-2113.59","994438.72","[expenditure, material-supply]"
"1","25/10/2019 00:00:00+00","-2612.1","991826.62","[expenditure, material-supply]"
"1","25/10/2019 00:00:00+00","-2326.4","989500.22","[expenditure, material-supply]"
"1","25/10/2019 00:00:00+00","-6715","982785.22","[expenditure, material-supply]"
"1","25/10/2019 00:00:00+00","-3735.52","979049.7","[expenditure, material-supply]"
"1","25/10/2019 00:00:00+00","-1263.5","977786.2","[expenditure, material-supply]"
"1","25/10/2019 00:00:00+00","-3338.99","974447.21","[expenditure, material-supply]"
"1","25/10/2019 00:00:00+00","-464.1","1481207.54","[expenditure]"
"1","25/10/2019 00:00:00+00","100","1481307.54","[revenue, sales]"
"1","25/10/2019 00:00:00+00","9130","1490437.54","[revenue]"
"1","25/10/2019 00:00:00+00","1330","1491767.54","[revenue, sales]"
"1","25/10/2019 00:00:00+00","8781.13","1500548.67","[revenue, sales]"
"1","25/10/2019 00:00:00+00","1904.8","1502453.47","[revenue, sales]"
"1","25/10/2019 00:00:00+00","100","1502553.47","[revenue, sales]"
"1","25/10/2019 00:00:00+00","355","1502908.47","[revenue]"
"1","25/10/2019 00:00:00+00","5200","1508108.47","[revenue, sales]"
"1","25/10/2019 00:00:00+00","1540","1509648.47","[revenue]"
"1","25/10/2019 00:00:00+00","100","1509748.47","[revenue]"
"1","25/10/2019 00:00:00+00","6550","1516298.47","[revenue]"
"1","25/10/2019 00:00:00+00","4700","979147.21","[revenue]"
"1","25/10/2019 00:00:00+00","14284.16","993431.37","[revenue, sales]"
"1","25/10/2019 00:00:00+00","-4","993427.37","[expenditure]"
"1","25/10/2019 00:00:00+00","-20.92","993406.45","[expenditure]"
"1","25/10/2019 00:00:00+00","-29.75","993376.7","[expenditure, material-supply]"
"1","25/10/2019 00:00:00+00","-42.65","993334.05","[expenditure]"
"1","28/10/2019 00:00:00+00","-2019.5","991314.55","[expenditure, material-supply]"
"1","28/10/2019 00:00:00+00","-2820.02","988494.53","[expenditure, material-supply]"
"1","28/10/2019 00:00:00+00","-1134.51","987360.02","[expenditure, material-supply]"
"1","28/10/2019 00:00:00+00","-3524.83","983835.19","[expenditure, material-supply]"
"1","28/10/2019 00:00:00+00","-7300","1508998.47","[expenditure, material-supply]"
"1","28/10/2019 00:00:00+00","-2104.8","981730.39","[expenditure, material-supply]"
"1","28/10/2019 00:00:00+00","-3472.5","978257.89","[expenditure, material-supply]"
"1","28/10/2019 00:00:00+00","-1659","976598.89","[expenditure, material-supply]"
"1","28/10/2019 00:00:00+00","-3429.95","973168.94","[expenditure, material-supply]"
"1","28/10/2019 00:00:00+00","-1334.5","971834.44","[expenditure, material-supply]"
"1","28/10/2019 00:00:00+00","-192.8","971641.64","[expenditure, material-supply]"
"1","28/10/2019 00:00:00+00","-4700","966941.64","[expenditure, material-supply]"
"1","28/10/2019 00:00:00+00","-1083","965858.64","[expenditure, material-supply]"
"1","28/10/2019 00:00:00+00","-50","965808.64","[expenditure, material-supply]"
"1","28/10/2019 00:00:00+00","-0.32","965808.32","[expenditure, material-supply]"
"1","28/10/2019 00:00:00+00","-0.15","965808.17","[expenditure, material-supply]"
"1","28/10/2019 00:00:00+00","-0.14","965808.03","[expenditure, material-supply]"
"1","28/10/2019 00:00:00+00","250000","1758998.47","[revenue, credit]"
"1","28/10/2019 00:00:00+00","2120","1761118.47","[revenue, sales]"
"1","28/10/2019 00:00:00+00","100","1761218.47","[revenue]"
"1","28/10/2019 00:00:00+00","100","1761318.47","[revenue, sales]"
"1","28/10/2019 00:00:00+00","3450","1764768.47","[revenue]"
"1","28/10/2019 00:00:00+00","19690","1784458.47","[revenue]"
"1","28/10/2019 00:00:00+00","5238.2","1789696.67","[revenue, sales]"
"1","28/10/2019 00:00:00+00","9624","1799320.67","[revenue, sales]"
"1","28/10/2019 00:00:00+00","1952.42","967760.45","[revenue, sales]"
"1","28/10/2019 00:00:00+00","2514.34","970274.79","[revenue, sales]"
"1","28/10/2019 00:00:00+00","2380","972654.79","[revenue]"
"1","28/10/2019 00:00:00+00","-69.32","972585.47","[expenditure]"
"1","28/10/2019 00:00:00+00","-190.11","972395.36","[expenditure, material-supply]"
"1","28/10/2019 00:00:00+00","-357.99","972037.37","[expenditure, material-supply]"
"1","28/10/2019 00:00:00+00","111.97","972149.34","[revenue]"
"1","28/10/2019 00:00:00+00","-17062.62","1782258.05","[expenditure]"
"1","29/10/2019 00:00:00+00","-975.8","1781282.25","[expenditure, material-supply]"
"1","29/10/2019 00:00:00+00","-121.48","972027.86","[expenditure, material-supply]"
"1","29/10/2019 00:00:00+00","-9463.22","962564.64","[expenditure, material-supply]"
"1","29/10/2019 00:00:00+00","-837.64","961727","[expenditure, material-supply]"
"1","29/10/2019 00:00:00+00","-10722.6","951004.4","[expenditure, material-supply]"
"1","29/10/2019 00:00:00+00","-11500.3","939504.1","[expenditure, material-supply]"
"1","29/10/2019 00:00:00+00","-1288.33","1779993.92","[expenditure, material-supply]"
"1","29/10/2019 00:00:00+00","-70.46","939433.64","[expenditure, material-supply]"
"1","29/10/2019 00:00:00+00","-367.71","939065.93","[expenditure, material-supply]"
"1","29/10/2019 00:00:00+00","-73.66","938992.27","[expenditure, material-supply]"
"1","29/10/2019 00:00:00+00","-2780","936212.27","[expenditure, material-supply]"
"1","29/10/2019 00:00:00+00","-359.98","935852.29","[expenditure, material-supply]"
"1","29/10/2019 00:00:00+00","-1130.5","934721.79","[expenditure, material-supply]"
"1","29/10/2019 00:00:00+00","-461.69","934260.1","[expenditure, transport, material-supply]"
"1","29/10/2019 00:00:00+00","-30.9","934229.2","[expenditure, material-supply]"
"1","29/10/2019 00:00:00+00","-65361.07","868868.13","[expenditure, material-supply]"
"1","29/10/2019 00:00:00+00","-120009.7","748858.43","[expenditure, material-supply]"
"1","29/10/2019 00:00:00+00","-40159.76","708698.67","[expenditure, material-supply]"
"1","29/10/2019 00:00:00+00","-25901.27","682797.4","[expenditure, material-supply]"
"1","29/10/2019 00:00:00+00","-750.43","682046.97","[expenditure, material-supply]"
"1","29/10/2019 00:00:00+00","-8825.07","673221.9","[expenditure, material-supply]"
"1","29/10/2019 00:00:00+00","-529.74","672692.16","[expenditure, material-supply]"
"1","29/10/2019 00:00:00+00","-3.82","672688.34","[expenditure, material-supply]"
"1","29/10/2019 00:00:00+00","-16.66","672671.68","[expenditure]"
"1","29/10/2019 00:00:00+00","-16.66","672655.02","[expenditure]"
"1","29/10/2019 00:00:00+00","-3615.01","669040.01","[expenditure, material-supply]"
"1","29/10/2019 00:00:00+00","-1934.41","1778059.51","[expenditure, material-supply]"
"1","29/10/2019 00:00:00+00","-1217.5","1776842.01","[expenditure, material-supply]"
"1","29/10/2019 00:00:00+00","-831","668209.01","[expenditure, material-supply]"
"1","29/10/2019 00:00:00+00","-888.5","667320.51","[expenditure, material-supply]"
"1","29/10/2019 00:00:00+00","-1629.9","665690.61","[expenditure, material-supply]"
"1","29/10/2019 00:00:00+00","-1213.88","664476.73","[expenditure, material-supply]"
"1","29/10/2019 00:00:00+00","-0.2","664476.53","[expenditure, material-supply]"
"1","29/10/2019 00:00:00+00","-30","664446.53","[expenditure, material-supply]"
"1","29/10/2019 00:00:00+00","-30","664416.53","[expenditure, material-supply]"
"1","29/10/2019 00:00:00+00","-30","664386.53","[expenditure, material-supply]"
"1","29/10/2019 00:00:00+00","4923.91","669310.44","[revenue, sales]"
"1","29/10/2019 00:00:00+00","2781.01","672091.45","[revenue, sales]"
"1","29/10/2019 00:00:00+00","100","672191.45","[revenue, sales]"
"1","29/10/2019 00:00:00+00","13177.18","685368.63","[revenue, sales]"
"1","29/10/2019 00:00:00+00","5250","1782092.01","[revenue, sales]"
"1","29/10/2019 00:00:00+00","6760","1788852.01","[revenue, sales]"
"1","29/10/2019 00:00:00+00","2446.21","1791298.22","[revenue, sales]"
"1","29/10/2019 00:00:00+00","6870","692238.63","[revenue]"
"1","29/10/2019 00:00:00+00","5860.52","698099.15","[revenue, sales]"
"1","29/10/2019 00:00:00+00","29342.36","727441.51","[revenue, sales]"
"1","29/10/2019 00:00:00+00","-37.94","727403.57","[expenditure]"
"1","29/10/2019 00:00:00+00","-3","727400.57","[expenditure]"
"1","29/10/2019 00:00:00+00","67.33","1791365.55","[revenue]"
"1","30/10/2019 00:00:00+00","-2697.51","724703.06","[expenditure, material-supply]"
"1","30/10/2019 00:00:00+00","-7497.98","717205.08","[expenditure, material-supply]"
"1","30/10/2019 00:00:00+00","-967","716238.08","[expenditure, material-supply]"
"1","30/10/2019 00:00:00+00","-1091.7","715146.38","[expenditure, material-supply]"
"1","30/10/2019 00:00:00+00","2600","717746.38","[revenue]"
"1","30/10/2019 00:00:00+00","7930","725676.38","[revenue, sales]"
"1","30/10/2019 00:00:00+00","1790.51","727466.89","[revenue, sales]"
"1","30/10/2019 00:00:00+00","1190.5","728657.39","[revenue, sales]"
"1","30/10/2019 00:00:00+00","6628.7","735286.09","[revenue, sales]"
"1","30/10/2019 00:00:00+00","4523.9","739809.99","[revenue, sales]"
"1","30/10/2019 00:00:00+00","100","739909.99","[revenue]"
"1","30/10/2019 00:00:00+00","4362.01","744272","[revenue, sales]"
"1","30/10/2019 00:00:00+00","2993.93","747265.93","[revenue, sales]"
"1","30/10/2019 00:00:00+00","17437","764702.93","[revenue, sales]"
"1","30/10/2019 00:00:00+00","55.53","764758.46","[revenue, sales]"
"1","30/10/2019 00:00:00+00","-4","764754.46","[expenditure]"
"1","30/10/2019 00:00:00+00","-4","1791361.55","[expenditure]"
"1","30/10/2019 00:00:00+00","-548.15","1790813.4","[expenditure, material-supply]"
"1","30/10/2019 00:00:00+00","-552.62","1790260.78","[expenditure, material-supply]"
"1","31/10/2019 00:00:00+00","-237.16","764517.3","[expenditure, material-supply]"
"1","31/10/2019 00:00:00+00","-190","764327.3","[expenditure, material-supply]"
"1","31/10/2019 00:00:00+00","-924.04","763403.26","[expenditure, material-supply]"
"1","31/10/2019 00:00:00+00","-1422.6","761980.66","[expenditure, material-supply]"
"1","31/10/2019 00:00:00+00","-494.18","761486.48","[expenditure, material-supply]"
"1","31/10/2019 00:00:00+00","-133","761353.48","[expenditure, salary, material-supply]"
"1","31/10/2019 00:00:00+00","75000","836353.48","[revenue, sales]"
"1","31/10/2019 00:00:00+00","5590.59","841944.07","[revenue, sales]"
"1","31/10/2019 00:00:00+00","100","842044.07","[revenue]"
"1","31/10/2019 00:00:00+00","2100","844144.07","[revenue]"
"1","31/10/2019 00:00:00+00","10500","1800760.78","[revenue]"
"1","31/10/2019 00:00:00+00","11962.42","856106.49","[revenue, sales]"
"1","31/10/2019 00:00:00+00","-4","856102.49","[expenditure]"
"1","31/10/2019 00:00:00+00","-4","856098.49","[expenditure]"
"1","31/10/2019 00:00:00+00","-115.99","855982.5","[expenditure]"
"1","1/11/2019 00:00:00+00","-1550","854432.5","[expenditure, material-supply]"
"1","1/11/2019 00:00:00+00","-3.34","854429.16","[expenditure]"
"1","1/11/2019 00:00:00+00","-2.1","854427.06","[expenditure]"
"1","1/11/2019 00:00:00+00","-837.5","853589.56","[expenditure, material-supply]"
"1","1/11/2019 00:00:00+00","-1035","852554.56","[expenditure, material-supply]"
"1","1/11/2019 00:00:00+00","-0.12","852554.44","[expenditure, material-supply]"
"1","1/11/2019 00:00:00+00","-0.16","852554.28","[expenditure, material-supply]"
"1","1/11/2019 00:00:00+00","-1973.01","850581.27","[expenditure, material-supply]"
"1","1/11/2019 00:00:00+00","-2010","848571.27","[expenditure, material-supply]"
"1","1/11/2019 00:00:00+00","-3570","845001.27","[expenditure, rent]"
"1","1/11/2019 00:00:00+00","-18594.17","826407.1","[expenditure]"
"1","1/11/2019 00:00:00+00","1973.01","828380.11","[revenue, sales]"
"1","1/11/2019 00:00:00+00","3000","831380.11","[revenue]"
"1","1/11/2019 00:00:00+00","6.15","831386.26","[revenue]"
"1","1/11/2019 00:00:00+00","7.56","831393.82","[revenue]"
"1","1/11/2019 00:00:00+00","5.5","831399.32","[revenue]"
"1","1/11/2019 00:00:00+00","12.95","831412.27","[revenue]"
"1","1/11/2019 00:00:00+00","2240","833652.27","[revenue]"
"1","1/11/2019 00:00:00+00","2900","836552.27","[revenue]"
"1","1/11/2019 00:00:00+00","2030","838582.27","[revenue]"
"1","1/11/2019 00:00:00+00","5150","843732.27","[revenue]"
"1","1/11/2019 00:00:00+00","1733.37","845465.64","[revenue, sales]"
"1","1/11/2019 00:00:00+00","2857.2","848322.84","[revenue, sales]"
"1","1/11/2019 00:00:00+00","3400","1804160.78","[revenue, sales]"
"1","1/11/2019 00:00:00+00","13500","1817660.78","[revenue]"
"1","1/11/2019 00:00:00+00","3850","1821510.78","[revenue]"
"1","1/11/2019 00:00:00+00","8800","1830310.78","[revenue]"
"1","1/11/2019 00:00:00+00","5760","1836070.78","[revenue, sales]"
"1","1/11/2019 00:00:00+00","15000","1851070.78","[revenue]"
"1","1/11/2019 00:00:00+00","45515.21","1896585.99","[revenue, sales]"
"1","1/11/2019 00:00:00+00","-38.86","1896547.13","[expenditure]"
"1","1/11/2019 00:00:00+00","-4","1896543.13","[expenditure]"
"1","1/11/2019 00:00:00+00","-1","1896542.13","[expenditure]"
"1","1/11/2019 00:00:00+00","-13","1896529.13","[expenditure]"
"1","1/11/2019 00:00:00+00","-1.15","1896527.98","[expenditure]"
"1","1/11/2019 00:00:00+00","-105.4","1896422.58","[expenditure]"
"1","4/11/2019 00:00:00+00","-0.28","848322.56","[expenditure, material-supply]"
"1","4/11/2019 00:00:00+00","-0.26","848322.3","[expenditure, material-supply]"
"1","4/11/2019 00:00:00+00","-0.07","848322.23","[expenditure, material-supply]"
"1","4/11/2019 00:00:00+00","-0.18","848322.05","[expenditure, material-supply]"
"1","4/11/2019 00:00:00+00","-597.53","847724.52","[expenditure]"
"1","4/11/2019 00:00:00+00","2590","1899012.58","[revenue]"
"1","4/11/2019 00:00:00+00","7260","1906272.58","[revenue, sales]"
"1","4/11/2019 00:00:00+00","700","1906972.58","[revenue]"
"1","4/11/2019 00:00:00+00","4500","1911472.58","[revenue]"
"1","4/11/2019 00:00:00+00","100","1911572.58","[revenue, sales]"
"1","4/11/2019 00:00:00+00","2704.24","1914276.82","[revenue, sales]"
"1","4/11/2019 00:00:00+00","1460","1915736.82","[revenue]"
"1","4/11/2019 00:00:00+00","2370","850094.52","[revenue]"
"1","4/11/2019 00:00:00+00","14100","864194.52","[revenue]"
"1","4/11/2019 00:00:00+00","4070","868264.52","[revenue]"
"1","4/11/2019 00:00:00+00","13797.02","882061.54","[revenue, sales]"
"1","4/11/2019 00:00:00+00","9172.15","891233.69","[revenue, sales]"
"1","5/11/2019 00:00:00+00","-1983.52","889250.17","[expenditure, material-supply]"
"1","5/11/2019 00:00:00+00","-3090","886160.17","[expenditure, material-supply]"
"1","5/11/2019 00:00:00+00","-1758.82","884401.35","[expenditure, material-supply]"
"1","5/11/2019 00:00:00+00","-2095.38","882305.97","[expenditure, material-supply]"
"1","5/11/2019 00:00:00+00","-2277.1","880028.87","[expenditure, material-supply]"
"1","5/11/2019 00:00:00+00","-6545.63","873483.24","[expenditure, material-supply]"
"1","5/11/2019 00:00:00+00","-1963.38","871519.86","[expenditure, material-supply]"
"1","5/11/2019 00:00:00+00","-3059.54","868460.32","[expenditure, material-supply]"
"1","5/11/2019 00:00:00+00","-1236.39","867223.93","[expenditure, material-supply]"
"1","5/11/2019 00:00:00+00","-2635.9","1913100.92","[expenditure, material-supply]"
"1","5/11/2019 00:00:00+00","-15376.63","851847.3","[expenditure, material-supply]"
"1","5/11/2019 00:00:00+00","-132.24","851715.06","[expenditure, material-supply]"
"1","5/11/2019 00:00:00+00","-775.29","850939.77","[expenditure, material-supply]"
"1","5/11/2019 00:00:00+00","-154.7","850785.07","[expenditure, material-supply]"
"1","5/11/2019 00:00:00+00","-45.08","850739.99","[expenditure, material-supply]"
"1","5/11/2019 00:00:00+00","-179.21","850560.78","[expenditure, material-supply]"
"1","5/11/2019 00:00:00+00","-362.95","850197.83","[expenditure, material-supply]"
"1","5/11/2019 00:00:00+00","-453.24","849744.59","[expenditure, material-supply]"
"1","5/11/2019 00:00:00+00","-216.53","849528.06","[expenditure, material-supply]"
"1","5/11/2019 00:00:00+00","-160.65","849367.41","[expenditure, material-supply]"
"1","5/11/2019 00:00:00+00","-0.29","849367.12","[expenditure, material-supply]"
"1","5/11/2019 00:00:00+00","-1624.3","847742.82","[expenditure, material-supply]"
"1","5/11/2019 00:00:00+00","-1239.8","846503.02","[expenditure, material-supply]"
"1","5/11/2019 00:00:00+00","-1689.99","844813.03","[expenditure, material-supply]"
"1","5/11/2019 00:00:00+00","-1071","843742.03","[expenditure, material-supply]"
"1","5/11/2019 00:00:00+00","-6630","837112.03","[expenditure, material-supply]"
"1","5/11/2019 00:00:00+00","-6090","831022.03","[expenditure, material-supply]"
"1","5/11/2019 00:00:00+00","-10672.5","1902428.42","[expenditure, material-supply]"
"1","5/11/2019 00:00:00+00","-417","1902011.42","[expenditure, material-supply]"
"1","5/11/2019 00:00:00+00","-2147.5","1899863.92","[expenditure, material-supply]"
"1","5/11/2019 00:00:00+00","-4894.5","1894969.42","[expenditure, material-supply]"
"1","5/11/2019 00:00:00+00","-1001.51","1893967.91","[expenditure, material-supply]"
"1","5/11/2019 00:00:00+00","-2234.9","1891733.01","[expenditure, material-supply]"
"1","5/11/2019 00:00:00+00","-1973.01","829049.02","[expenditure, material-supply]"
"1","5/11/2019 00:00:00+00","-1043.5","828005.52","[expenditure, material-supply]"
"1","5/11/2019 00:00:00+00","75","828080.52","[revenue]"
"1","5/11/2019 00:00:00+00","9310","837390.52","[revenue]"
"1","5/11/2019 00:00:00+00","30","837420.52","[revenue]"
"1","5/11/2019 00:00:00+00","3877.04","841297.56","[revenue, sales]"
"1","5/11/2019 00:00:00+00","3450","844747.56","[revenue, sales]"
"1","5/11/2019 00:00:00+00","5586.1","850333.66","[revenue, sales]"
"1","5/11/2019 00:00:00+00","2516.17","852849.83","[revenue, sales]"
"1","5/11/2019 00:00:00+00","60","1891793.01","[revenue]"
"1","5/11/2019 00:00:00+00","8700","1900493.01","[revenue]"
"1","5/11/2019 00:00:00+00","1940","854789.83","[revenue]"
"1","5/11/2019 00:00:00+00","1641.33","856431.16","[revenue, sales]"
"1","5/11/2019 00:00:00+00","14741.18","871172.34","[revenue, sales]"
"1","5/11/2019 00:00:00+00","-60.25","871112.09","[expenditure]"
"1","5/11/2019 00:00:00+00","-4","871108.09","[expenditure]"
"1","5/11/2019 00:00:00+00","-158.18","870949.91","[expenditure]"
"1","6/11/2019 00:00:00+00","-19845","851104.91","[expenditure, material-supply]"
"1","6/11/2019 00:00:00+00","-7500.05","843604.86","[expenditure, material-supply]"
"1","6/11/2019 00:00:00+00","-7462","836142.86","[expenditure, material-supply]"
"1","6/11/2019 00:00:00+00","-1198","834944.86","[expenditure, material-supply]"
"1","6/11/2019 00:00:00+00","3890","838834.86","[revenue, sales]"
"1","6/11/2019 00:00:00+00","1171.45","840006.31","[revenue, sales]"
"1","6/11/2019 00:00:00+00","3485.78","843492.09","[revenue, sales]"
"1","6/11/2019 00:00:00+00","4981.05","848473.14","[revenue, sales]"
"1","6/11/2019 00:00:00+00","1542.89","850016.03","[revenue, sales]"
"1","6/11/2019 00:00:00+00","2219.09","852235.12","[revenue, sales]"
"1","6/11/2019 00:00:00+00","1980.99","854216.11","[revenue, sales]"
"1","6/11/2019 00:00:00+00","100","854316.11","[revenue]"
"1","6/11/2019 00:00:00+00","2090","856406.11","[revenue, sales]"
"1","6/11/2019 00:00:00+00","50","856456.11","[revenue]"
"1","6/11/2019 00:00:00+00","10490","866946.11","[revenue, sales]"
"1","6/11/2019 00:00:00+00","1618.67","868564.78","[revenue, sales]"
"1","6/11/2019 00:00:00+00","40","868604.78","[revenue, sales]"
"1","6/11/2019 00:00:00+00","100","868704.78","[revenue]"
"1","6/11/2019 00:00:00+00","11786.34","880491.12","[revenue, sales]"
"1","6/11/2019 00:00:00+00","2930","883421.12","[revenue]"
"1","6/11/2019 00:00:00+00","3273.01","886694.13","[revenue, sales]"
"1","6/11/2019 00:00:00+00","111.11","886805.24","[revenue, sales]"
"1","6/11/2019 00:00:00+00","-249.08","886556.16","[leasing, expenditure, material-supply]"
"1","7/11/2019 00:00:00+00","-2349.81","884206.35","[expenditure, material-supply]"
"1","7/11/2019 00:00:00+00","-1605","882601.35","[expenditure, material-supply]"
"1","7/11/2019 00:00:00+00","-6060.28","1894432.73","[expenditure, material-supply]"
"1","7/11/2019 00:00:00+00","-1366.9","1893065.83","[expenditure, material-supply]"
"1","7/11/2019 00:00:00+00","-2650.9","1890414.93","[expenditure, material-supply]"
"1","7/11/2019 00:00:00+00","-1536","1888878.93","[expenditure, material-supply]"
"1","7/11/2019 00:00:00+00","-8700","1880178.93","[expenditure, material-supply]"
"1","7/11/2019 00:00:00+00","-100","1880078.93","[expenditure, material-supply]"
"1","7/11/2019 00:00:00+00","-2748.51","879852.84","[expenditure, material-supply]"
"1","7/11/2019 00:00:00+00","-671.1","879181.74","[expenditure, material-supply]"
"1","7/11/2019 00:00:00+00","-4115.7","875066.04","[expenditure, material-supply]"
"1","7/11/2019 00:00:00+00","-3112","871954.04","[expenditure, material-supply]"
"1","7/11/2019 00:00:00+00","-0.15","871953.89","[expenditure, material-supply]"
"1","7/11/2019 00:00:00+00","18262.5","890216.39","[revenue, sales]"
"1","7/11/2019 00:00:00+00","4400","894616.39","[revenue, sales]"
"1","7/11/2019 00:00:00+00","1795.27","896411.66","[revenue, sales]"
"1","7/11/2019 00:00:00+00","7685.87","904097.53","[revenue, sales]"
"1","7/11/2019 00:00:00+00","7295.38","911392.91","[revenue, sales]"
"1","7/11/2019 00:00:00+00","150","911542.91","[revenue, sales]"
"1","7/11/2019 00:00:00+00","9110","920652.91","[revenue, sales]"
"1","7/11/2019 00:00:00+00","5234.88","925887.79","[revenue, sales]"
"1","7/11/2019 00:00:00+00","0.46","925888.25","[revenue, sales]"
"1","7/11/2019 00:00:00+00","-4","925884.25","[expenditure]"
"1","7/11/2019 00:00:00+00","-6","925878.25","[expenditure, material-supply]"
"1","8/11/2019 00:00:00+00","-3611.02","922267.23","[expenditure, material-supply]"
"1","8/11/2019 00:00:00+00","-12096.89","910170.34","[expenditure, material-supply]"
"1","8/11/2019 00:00:00+00","-1078","909092.34","[expenditure, material-supply]"
"1","8/11/2019 00:00:00+00","-4761.69","904330.65","[expenditure, material-supply]"
"1","8/11/2019 00:00:00+00","-1962.29","902368.36","[expenditure, material-supply]"
"1","8/11/2019 00:00:00+00","-30","902338.36","[expenditure, material-supply]"
"1","8/11/2019 00:00:00+00","-1663.5","900674.86","[expenditure, material-supply]"
"1","8/11/2019 00:00:00+00","-338.3","900336.56","[expenditure, material-supply]"
"1","8/11/2019 00:00:00+00","-676.4","1879402.53","[expenditure, material-supply]"
"1","8/11/2019 00:00:00+00","-3925.13","1875477.4","[expenditure, material-supply]"
"1","8/11/2019 00:00:00+00","-3204.5","1872272.9","[expenditure, material-supply]"
"1","8/11/2019 00:00:00+00","-3087.3","897249.26","[expenditure, material-supply]"
"1","8/11/2019 00:00:00+00","-11400","885849.26","[expenditure, material-supply]"
"1","8/11/2019 00:00:00+00","-0.49","885848.77","[expenditure, material-supply]"
"1","8/11/2019 00:00:00+00","-13794.71","872054.06","[expenditure, tax]"
"1","8/11/2019 00:00:00+00","-5.16","872048.9","[expenditure, material-supply]"
"1","8/11/2019 00:00:00+00","-707.6","871341.3","[expenditure, material-supply]"
"1","8/11/2019 00:00:00+00","-980.12","870361.18","[expenditure, material-supply]"
"1","8/11/2019 00:00:00+00","-1235.08","869126.1","[expenditure, material-supply]"
"1","8/11/2019 00:00:00+00","-300","868826.1","[expenditure, material-supply]"
"1","8/11/2019 00:00:00+00","-950.81","867875.29","[expenditure, material-supply]"
"1","8/11/2019 00:00:00+00","-821.1","867054.19","[expenditure, material-supply]"
"1","8/11/2019 00:00:00+00","-100.88","866953.31","[expenditure, material-supply]"
"1","8/11/2019 00:00:00+00","-94.85","866858.46","[expenditure, material-supply]"
"1","8/11/2019 00:00:00+00","-238.04","866620.42","[expenditure, material-supply]"
"1","8/11/2019 00:00:00+00","-27.85","866592.57","[expenditure, material-supply]"
"1","8/11/2019 00:00:00+00","-46.41","866546.16","[expenditure, material-supply]"
"1","8/11/2019 00:00:00+00","-1047.2","865498.96","[expenditure, material-supply]"
"1","8/11/2019 00:00:00+00","-76.16","865422.8","[expenditure, material-supply]"
"1","8/11/2019 00:00:00+00","-710","864712.8","[expenditure, material-supply]"
"1","8/11/2019 00:00:00+00","-330","864382.8","[expenditure, material-supply]"
"1","8/11/2019 00:00:00+00","2250","866632.8","[revenue]"
"1","8/11/2019 00:00:00+00","1514.32","868147.12","[revenue, sales]"
"1","8/11/2019 00:00:00+00","7343","875490.12","[revenue, sales]"
"1","8/11/2019 00:00:00+00","12018.83","887508.95","[revenue, sales]"
"1","8/11/2019 00:00:00+00","5474.34","892983.29","[revenue, sales]"
"1","8/11/2019 00:00:00+00","100","893083.29","[revenue]"
"1","8/11/2019 00:00:00+00","3000","896083.29","[revenue, sales]"
"1","8/11/2019 00:00:00+00","50","896133.29","[revenue]"
"1","8/11/2019 00:00:00+00","1760.85","897894.14","[revenue, sales]"
"1","8/11/2019 00:00:00+00","-34.36","897859.78","[expenditure, credit-card]"
"1","8/11/2019 00:00:00+00","-4","897855.78","[expenditure]"
"1","8/11/2019 00:00:00+00","-445.74","897410.04","[expenditure, material-supply]"
"1","11/11/2019 00:00:00+00","-1241.5","896168.54","[expenditure, material-supply]"
"1","11/11/2019 00:00:00+00","-1117","1871155.9","[expenditure, material-supply]"
"1","11/11/2019 00:00:00+00","-2919","1868236.9","[expenditure, material-supply]"
"1","11/11/2019 00:00:00+00","-4418","1863818.9","[expenditure, material-supply]"
"1","11/11/2019 00:00:00+00","-3632","1860186.9","[expenditure, material-supply]"
"1","11/11/2019 00:00:00+00","-628","1859558.9","[expenditure, material-supply]"
"1","11/11/2019 00:00:00+00","-10463.41","1849095.49","[expenditure, material-supply]"
"1","11/11/2019 00:00:00+00","-2305.12","1846790.37","[expenditure, material-supply]"
"1","11/11/2019 00:00:00+00","-6225","1840565.37","[expenditure, material-supply]"
"1","11/11/2019 00:00:00+00","-2409.27","1838156.1","[expenditure, material-supply]"
"1","11/11/2019 00:00:00+00","-3570","1834586.1","[expenditure]"
"1","11/11/2019 00:00:00+00","-1850.71","1832735.39","[expenditure]"
"1","11/11/2019 00:00:00+00","-0.22","1832735.17","[expenditure, material-supply]"
"1","11/11/2019 00:00:00+00","-0.49","896168.05","[expenditure, material-supply]"
"1","11/11/2019 00:00:00+00","-0.04","896168.01","[expenditure, material-supply]"
"1","11/11/2019 00:00:00+00","-0.09","896167.92","[expenditure, material-supply]"
"1","11/11/2019 00:00:00+00","-0.3","896167.62","[expenditure, material-supply]"
"1","11/11/2019 00:00:00+00","-3850","892317.62","[expenditure, material-supply]"
"1","11/11/2019 00:00:00+00","-5850","1826885.17","[expenditure, material-supply]"
"1","11/11/2019 00:00:00+00","4650","1831535.17","[revenue, sales]"
"1","11/11/2019 00:00:00+00","60","892377.62","[revenue]"
"1","11/11/2019 00:00:00+00","1619.08","893996.7","[revenue, sales]"
"1","11/11/2019 00:00:00+00","990.5","894987.2","[revenue, sales]"
"1","11/11/2019 00:00:00+00","3952.46","898939.66","[revenue, sales]"
"1","11/11/2019 00:00:00+00","1200","900139.66","[revenue]"
"1","11/11/2019 00:00:00+00","3466.11","1835001.28","[revenue, sales]"
"1","11/11/2019 00:00:00+00","-4","1834997.28","[expenditure]"
"1","11/11/2019 00:00:00+00","-4","1834993.28","[expenditure, credit-card]"
"1","11/11/2019 00:00:00+00","-15778.36","1819214.92","[expenditure, material-supply]"
"1","12/11/2019 00:00:00+00","-569.8","899569.86","[expenditure, material-supply]"
"1","12/11/2019 00:00:00+00","-710","898859.86","[expenditure, material-supply]"
"1","12/11/2019 00:00:00+00","-622.9","898236.96","[expenditure, material-supply]"
"1","12/11/2019 00:00:00+00","-2768.8","895468.16","[expenditure, material-supply]"
"1","12/11/2019 00:00:00+00","-2181.3","893286.86","[expenditure, material-supply]"
"1","12/11/2019 00:00:00+00","-1512.5","891774.36","[expenditure, material-supply]"
"1","12/11/2019 00:00:00+00","-595","891179.36","[expenditure, material-supply]"
"1","12/11/2019 00:00:00+00","-287.98","890891.38","[expenditure, material-supply]"
"1","12/11/2019 00:00:00+00","-11900","878991.38","[expenditure, material-supply]"
"1","12/11/2019 00:00:00+00","-294","878697.38","[expenditure, material-supply]"
"1","12/11/2019 00:00:00+00","-203.49","878493.89","[expenditure, material-supply]"
"1","12/11/2019 00:00:00+00","-140","878353.89","[expenditure, material-supply]"
"1","12/11/2019 00:00:00+00","-262.26","878091.63","[expenditure, material-supply]"
"1","12/11/2019 00:00:00+00","-148.07","877943.56","[expenditure, material-supply]"
"1","12/11/2019 00:00:00+00","-110","877833.56","[expenditure, material-supply]"
"1","12/11/2019 00:00:00+00","-23.8","877809.76","[expenditure, material-supply]"
"1","12/11/2019 00:00:00+00","-707.6","877102.16","[expenditure, material-supply]"
"1","12/11/2019 00:00:00+00","-122.96","876979.2","[expenditure, material-supply]"
"1","12/11/2019 00:00:00+00","-227.89","876751.31","[expenditure, material-supply]"
"1","12/11/2019 00:00:00+00","-64","876687.31","[expenditure, material-supply]"
"1","12/11/2019 00:00:00+00","-64","876623.31","[expenditure, material-supply]"
"1","12/11/2019 00:00:00+00","-858.59","875764.72","[expenditure, material-supply]"
"1","12/11/2019 00:00:00+00","-392.22","875372.5","[expenditure, material-supply]"
"1","12/11/2019 00:00:00+00","-243.95","875128.55","[expenditure, material-supply]"
"1","12/11/2019 00:00:00+00","-46020.81","829107.74","[expenditure, material-supply]"
"1","12/11/2019 00:00:00+00","-0.36","829107.38","[expenditure, material-supply]"
"1","12/11/2019 00:00:00+00","1990","831097.38","[revenue]"
"1","12/11/2019 00:00:00+00","100000","931097.38","[revenue, sales]"
"1","12/11/2019 00:00:00+00","1514.32","932611.7","[revenue, sales]"
"1","12/11/2019 00:00:00+00","4120","936731.7","[revenue]"
"1","12/11/2019 00:00:00+00","100","936831.7","[revenue, sales]"
"1","12/11/2019 00:00:00+00","7014.19","943845.89","[revenue, sales]"
"1","12/11/2019 00:00:00+00","100","943945.89","[revenue]"
"1","12/11/2019 00:00:00+00","19171.1","963116.99","[revenue, sales]"
"1","12/11/2019 00:00:00+00","-4","963112.99","[expenditure]"
"1","12/11/2019 00:00:00+00","-4","963108.99","[expenditure]"
"1","12/11/2019 00:00:00+00","-1835.5","961273.49","[expenditure, material-supply]"
"1","13/11/2019 00:00:00+00","-797.5","960475.99","[expenditure, material-supply]"
"1","13/11/2019 00:00:00+00","-1751.71","1817463.21","[expenditure, material-supply]"
"1","13/11/2019 00:00:00+00","-1104.4","1816358.81","[expenditure, material-supply]"
"1","13/11/2019 00:00:00+00","-1607","1814751.81","[expenditure, material-supply]"
"1","13/11/2019 00:00:00+00","-4975.6","1809776.21","[expenditure, material-supply]"
"1","13/11/2019 00:00:00+00","-949.42","1808826.79","[expenditure, material-supply]"
"1","13/11/2019 00:00:00+00","-1443.8","1807382.99","[expenditure, material-supply]"
"1","13/11/2019 00:00:00+00","-983.27","1806399.72","[expenditure, material-supply]"
"1","13/11/2019 00:00:00+00","-890","1805509.72","[expenditure, material-supply]"
"1","13/11/2019 00:00:00+00","-471.4","1805038.32","[expenditure, material-supply]"
"1","13/11/2019 00:00:00+00","-1170.23","1803868.09","[expenditure, material-supply]"
"1","13/11/2019 00:00:00+00","-0.05","1803868.04","[expenditure, material-supply]"
"1","13/11/2019 00:00:00+00","-0.37","1803867.67","[expenditure, material-supply]"
"1","13/11/2019 00:00:00+00","6560","967035.99","[revenue, sales]"
"1","13/11/2019 00:00:00+00","1800","968835.99","[revenue]"
"1","13/11/2019 00:00:00+00","2142.9","970978.89","[revenue, sales]"
"1","13/11/2019 00:00:00+00","8187.29","979166.18","[revenue, sales]"
"1","13/11/2019 00:00:00+00","2967.99","982134.17","[revenue, sales]"
"1","13/11/2019 00:00:00+00","1797.27","983931.44","[revenue, sales]"
"1","13/11/2019 00:00:00+00","50","983981.44","[revenue, sales]"
"1","13/11/2019 00:00:00+00","100","984081.44","[revenue]"
"1","13/11/2019 00:00:00+00","33.88","984115.32","[revenue]"
"1","13/11/2019 00:00:00+00","100","984215.32","[revenue]"
"1","14/11/2019 00:00:00+00","-115","984100.32","[expenditure, salary, material-supply]"
"1","14/11/2019 00:00:00+00","-411.01","983689.31","[expenditure, material-supply]"
"1","14/11/2019 00:00:00+00","-2370.93","1801496.74","[expenditure, material-supply]"
"1","14/11/2019 00:00:00+00","-3905.92","1797590.82","[expenditure, material-supply]"
"1","14/11/2019 00:00:00+00","-138.04","1797452.78","[expenditure, material-supply]"
"1","14/11/2019 00:00:00+00","-90.31","1797362.47","[expenditure, material-supply]"
"1","14/11/2019 00:00:00+00","-903.27","1796459.2","[expenditure, material-supply]"
"1","14/11/2019 00:00:00+00","-587.6","1795871.6","[expenditure, material-supply]"
"1","14/11/2019 00:00:00+00","-2892.95","980796.36","[expenditure, material-supply]"
"1","14/11/2019 00:00:00+00","-20.71","1795850.89","[expenditure, material-supply]"
"1","14/11/2019 00:00:00+00","-6247.5","1789603.39","[expenditure, material-supply]"
"1","14/11/2019 00:00:00+00","-754.46","1788848.93","[expenditure, material-supply]"
"1","14/11/2019 00:00:00+00","-126.02","980670.34","[expenditure, material-supply]"
"1","14/11/2019 00:00:00+00","-203.23","980467.11","[expenditure, material-supply]"
"1","14/11/2019 00:00:00+00","-618.8","979848.31","[expenditure, material-supply]"
"1","14/11/2019 00:00:00+00","-940.1","978908.21","[expenditure, material-supply]"
"1","14/11/2019 00:00:00+00","-533.94","978374.27","[expenditure, material-supply]"
"1","14/11/2019 00:00:00+00","-520.14","977854.13","[expenditure, transport, material-supply]"
"1","14/11/2019 00:00:00+00","-284.55","977569.58","[expenditure, rent]"
"1","14/11/2019 00:00:00+00","100","977669.58","[revenue]"
"1","14/11/2019 00:00:00+00","1780","979449.58","[revenue]"
"1","14/11/2019 00:00:00+00","1850","981299.58","[revenue, sales]"
"1","14/11/2019 00:00:00+00","1371.46","982671.04","[revenue, sales]"
"1","14/11/2019 00:00:00+00","1561.94","984232.98","[revenue, sales]"
"1","14/11/2019 00:00:00+00","1952.42","986185.4","[revenue, sales]"
"1","14/11/2019 00:00:00+00","3550","989735.4","[revenue, sales]"
"1","14/11/2019 00:00:00+00","4334.68","994070.08","[revenue, sales]"
"1","14/11/2019 00:00:00+00","8750","1002820.08","[revenue, sales]"
"1","14/11/2019 00:00:00+00","1622.4","1004442.48","[revenue, sales]"
"1","14/11/2019 00:00:00+00","1136.65","1005579.13","[revenue, sales]"
"1","14/11/2019 00:00:00+00","19790","1025369.13","[revenue]"
"1","14/11/2019 00:00:00+00","34.15","1025403.28","[revenue, sales]"
"1","14/11/2019 00:00:00+00","-4","1025399.28","[expenditure]"
"1","14/11/2019 00:00:00+00","-4","1025395.28","[expenditure, credit-card]"
"1","15/11/2019 00:00:00+00","-270","1025125.28","[expenditure, material-supply]"
"1","15/11/2019 00:00:00+00","-225","1024900.28","[expenditure, material-supply]"
"1","15/11/2019 00:00:00+00","-5390","1019510.28","[expenditure, material-supply]"
"1","15/11/2019 00:00:00+00","-980.5","1018529.78","[expenditure, material-supply]"
"1","15/11/2019 00:00:00+00","-2991.1","1015538.68","[expenditure, material-supply]"
"1","15/11/2019 00:00:00+00","-4343","1011195.68","[expenditure, material-supply]"
"1","15/11/2019 00:00:00+00","-5575","1005620.68","[expenditure, material-supply]"
"1","15/11/2019 00:00:00+00","-2041.5","1003579.18","[expenditure, material-supply]"
"1","15/11/2019 00:00:00+00","-1675.9","1001903.28","[expenditure, material-supply]"
"1","15/11/2019 00:00:00+00","-2131.2","999772.08","[expenditure, material-supply]"
"1","15/11/2019 00:00:00+00","-1792.5","997979.58","[expenditure, material-supply]"
"1","15/11/2019 00:00:00+00","-2282.98","995696.6","[expenditure, material-supply]"
"1","15/11/2019 00:00:00+00","-13783","981913.6","[expenditure, material-supply]"
"1","15/11/2019 00:00:00+00","-11477","970436.6","[expenditure, material-supply]"
"1","15/11/2019 00:00:00+00","-331.62","970104.98","[expenditure, material-supply]"
"1","15/11/2019 00:00:00+00","-2059.5","968045.48","[expenditure, material-supply]"
"1","15/11/2019 00:00:00+00","-15080.03","952965.45","[expenditure, material-supply]"
"1","15/11/2019 00:00:00+00","-9373.43","1779475.5","[expenditure, material-supply]"
"1","15/11/2019 00:00:00+00","-7041","1772434.5","[expenditure, material-supply]"
"1","15/11/2019 00:00:00+00","-11201.75","1761232.75","[expenditure, material-supply]"
"1","15/11/2019 00:00:00+00","-8628","1752604.75","[expenditure, material-supply]"
"1","15/11/2019 00:00:00+00","-11708.02","1740896.73","[expenditure, material-supply]"
"1","15/11/2019 00:00:00+00","-3562.83","1737333.9","[expenditure, material-supply]"
"1","15/11/2019 00:00:00+00","-1271","1736062.9","[expenditure, material-supply]"
"1","15/11/2019 00:00:00+00","-1080","1734982.9","[expenditure, material-supply]"
"1","15/11/2019 00:00:00+00","-0.29","1734982.61","[expenditure, material-supply]"
"1","15/11/2019 00:00:00+00","-0.45","1734982.16","[expenditure, material-supply]"
"1","15/11/2019 00:00:00+00","-0.16","1734982","[expenditure, material-supply]"
"1","15/11/2019 00:00:00+00","-0.03","1734981.97","[expenditure, material-supply]"
"1","15/11/2019 00:00:00+00","-0.45","1734981.52","[expenditure, material-supply]"
"1","15/11/2019 00:00:00+00","8890","1743871.52","[revenue, sales]"
"1","15/11/2019 00:00:00+00","5714.4","1749585.92","[revenue, sales]"
"1","15/11/2019 00:00:00+00","6576.32","1756162.24","[revenue, sales]"
"1","15/11/2019 00:00:00+00","2859.32","1759021.56","[revenue, sales]"
"1","15/11/2019 00:00:00+00","3390.52","956355.97","[revenue, sales]"
"1","15/11/2019 00:00:00+00","1518.92","957874.89","[revenue, sales]"
"1","15/11/2019 00:00:00+00","4381.06","962255.95","[revenue, sales]"
"1","15/11/2019 00:00:00+00","7416.9","969672.85","[revenue, sales]"
"1","15/11/2019 00:00:00+00","2000","971672.85","[revenue]"
"1","15/11/2019 00:00:00+00","50","971722.85","[revenue, sales]"
"1","15/11/2019 00:00:00+00","34566.28","1006289.13","[revenue, sales]"
"1","15/11/2019 00:00:00+00","-4","1006285.13","[expenditure]"
"1","15/11/2019 00:00:00+00","-32.75","1006252.38","[expenditure, credit-card]"
"1","15/11/2019 00:00:00+00","-3","1006249.38","[expenditure]"
"1","15/11/2019 00:00:00+00","-19","1006230.38","[expenditure]"
"1","15/11/2019 00:00:00+00","-19","1006211.38","[expenditure]"
"1","15/11/2019 00:00:00+00","-19","1006192.38","[expenditure]"
"1","15/11/2019 00:00:00+00","-19","1006173.38","[expenditure]"
"1","15/11/2019 00:00:00+00","-19","1006154.38","[expenditure]"
"1","15/11/2019 00:00:00+00","-19","1006135.38","[expenditure]"
"1","15/11/2019 00:00:00+00","-395.79","1005739.59","[expenditure, material-supply]"
"1","15/11/2019 00:00:00+00","-28097.79","977641.8","[expenditure, material-supply]"
"1","15/11/2019 00:00:00+00","-1129.19","976512.61","[expenditure, administration, material-supply]"
"1","15/11/2019 00:00:00+00","-32328.47","944184.14","[expenditure, credit-card, credit, material-supply]"
"1","18/11/2019 00:00:00+00","-16600","927584.14","[expenditure, material-supply]"
"1","18/11/2019 00:00:00+00","-4070","923514.14","[expenditure, material-supply]"
"1","18/11/2019 00:00:00+00","-30","923484.14","[expenditure, material-supply]"
"1","18/11/2019 00:00:00+00","-770.18","922713.96","[expenditure]"
"1","18/11/2019 00:00:00+00","-3706.01","919007.95","[expenditure, material-supply]"
"1","18/11/2019 00:00:00+00","-2150.2","916857.75","[expenditure, material-supply]"
"1","18/11/2019 00:00:00+00","-4246.58","912611.17","[expenditure, material-supply]"
"1","18/11/2019 00:00:00+00","-4084.8","908526.37","[expenditure, material-supply]"
"1","18/11/2019 00:00:00+00","-8396","900130.37","[expenditure, material-supply]"
"1","18/11/2019 00:00:00+00","-41.29","900089.08","[expenditure, material-supply]"
"1","18/11/2019 00:00:00+00","-14930","885159.08","[expenditure, material-supply]"
"1","18/11/2019 00:00:00+00","-2296.8","882862.28","[expenditure, material-supply]"
"1","18/11/2019 00:00:00+00","-0.12","882862.16","[expenditure, material-supply]"
"1","18/11/2019 00:00:00+00","-0.27","882861.89","[expenditure, material-supply]"
"1","18/11/2019 00:00:00+00","9798.48","892660.37","[revenue, sales]"
"1","18/11/2019 00:00:00+00","30","892690.37","[revenue]"
"1","18/11/2019 00:00:00+00","16700","909390.37","[revenue]"
"1","18/11/2019 00:00:00+00","1300","910690.37","[revenue]"
"1","18/11/2019 00:00:00+00","9333.52","920023.89","[revenue, sales]"
"1","18/11/2019 00:00:00+00","9009.7","929033.59","[revenue, sales]"
"1","18/11/2019 00:00:00+00","1714.32","930747.91","[revenue, sales]"
"1","18/11/2019 00:00:00+00","1904.8","932652.71","[revenue, sales]"
"1","18/11/2019 00:00:00+00","1000","933652.71","[revenue]"
"1","18/11/2019 00:00:00+00","1100","934752.71","[revenue]"
"1","18/11/2019 00:00:00+00","8200","942952.71","[revenue]"
"1","18/11/2019 00:00:00+00","23000","965952.71","[revenue, sales]"
"1","18/11/2019 00:00:00+00","4350","970302.71","[revenue, sales]"
"1","18/11/2019 00:00:00+00","2200","972502.71","[revenue, sales]"
"1","18/11/2019 00:00:00+00","2161.45","974664.16","[revenue, sales]"
"1","18/11/2019 00:00:00+00","3274.92","977939.08","[revenue, sales]"
"1","18/11/2019 00:00:00+00","100","1759121.56","[revenue]"
"1","18/11/2019 00:00:00+00","750","1759871.56","[revenue]"
"1","18/11/2019 00:00:00+00","1013.76","1760885.32","[revenue, sales]"
"1","18/11/2019 00:00:00+00","-19.47","1760865.85","[expenditure, credit-card]"
"1","18/11/2019 00:00:00+00","-19","1760846.85","[expenditure]"
"1","19/11/2019 00:00:00+00","-1508.8","1759338.05","[expenditure, material-supply]"
"1","19/11/2019 00:00:00+00","-542.9","1758795.15","[expenditure, material-supply]"
"1","19/11/2019 00:00:00+00","-2274.5","975664.58","[expenditure, material-supply]"
"1","19/11/2019 00:00:00+00","-1132.5","974532.08","[expenditure, material-supply]"
"1","19/11/2019 00:00:00+00","-5359.5","969172.58","[expenditure, material-supply]"
"1","19/11/2019 00:00:00+00","-2352.7","966819.88","[expenditure, material-supply]"
"1","19/11/2019 00:00:00+00","-6861","959958.88","[expenditure, material-supply]"
"1","19/11/2019 00:00:00+00","-2950","957008.88","[expenditure, material-supply]"
"1","19/11/2019 00:00:00+00","-6688.4","950320.48","[expenditure, material-supply]"
"1","19/11/2019 00:00:00+00","-520.5","949799.98","[expenditure, material-supply]"
"1","19/11/2019 00:00:00+00","-5292.7","1753502.45","[expenditure, material-supply]"
"1","19/11/2019 00:00:00+00","-8280","1745222.45","[expenditure, material-supply]"
"1","19/11/2019 00:00:00+00","-0.39","1745222.06","[expenditure, material-supply]"
"1","19/11/2019 00:00:00+00","-2142","1743080.06","[expenditure, material-supply]"
"1","19/11/2019 00:00:00+00","-850","1742230.06","[expenditure, material-supply]"
"1","19/11/2019 00:00:00+00","-1100","1741130.06","[expenditure, material-supply]"
"1","19/11/2019 00:00:00+00","-398.65","1740731.41","[expenditure, material-supply]"
"1","19/11/2019 00:00:00+00","-137.22","1740594.19","[expenditure, material-supply]"
"1","19/11/2019 00:00:00+00","-59.99","1740534.2","[expenditure, material-supply]"
"1","19/11/2019 00:00:00+00","-145.99","1740388.21","[expenditure, material-supply]"
"1","19/11/2019 00:00:00+00","-1311.45","948488.53","[expenditure, material-supply]"
"1","19/11/2019 00:00:00+00","-28.5","948460.03","[expenditure, transport, material-supply]"
"1","19/11/2019 00:00:00+00","-679.03","947781","[expenditure, material-supply]"
"1","19/11/2019 00:00:00+00","-380.8","947400.2","[expenditure, material-supply]"
"1","19/11/2019 00:00:00+00","-347.4","947052.8","[expenditure, transport, material-supply]"
"1","19/11/2019 00:00:00+00","-12495","934557.8","[expenditure, material-supply]"
"1","19/11/2019 00:00:00+00","-7397.08","927160.72","[expenditure, material-supply]"
"1","19/11/2019 00:00:00+00","-44.6","927116.12","[expenditure, material-supply]"
"1","19/11/2019 00:00:00+00","-296.31","926819.81","[expenditure, credit-card, material-supply]"
"1","19/11/2019 00:00:00+00","-2784.57","924035.24","[expenditure]"
"1","19/11/2019 00:00:00+00","65000","989035.24","[revenue, sales]"
"1","19/11/2019 00:00:00+00","4571.52","993606.76","[revenue, sales]"
"1","19/11/2019 00:00:00+00","5895.36","999502.12","[revenue, sales]"
"1","19/11/2019 00:00:00+00","2238.14","1001740.26","[revenue, sales]"
"1","19/11/2019 00:00:00+00","16767","1018507.26","[revenue, sales]"
"1","19/11/2019 00:00:00+00","5054.38","1023561.64","[revenue, sales]"
"1","19/11/2019 00:00:00+00","4300","1027861.64","[revenue, sales]"
"1","19/11/2019 00:00:00+00","17176.03","1045037.67","[revenue, sales]"
"1","19/11/2019 00:00:00+00","2130","1047167.67","[revenue]"
"1","19/11/2019 00:00:00+00","90","1047257.67","[revenue]"
"1","19/11/2019 00:00:00+00","36300.57","1083558.24","[revenue]"
"1","19/11/2019 00:00:00+00","1750","1085308.24","[revenue]"
"1","19/11/2019 00:00:00+00","-26.39","1085281.85","[expenditure]"
"1","19/11/2019 00:00:00+00","113.29","1740501.5","[revenue]"
"1","20/11/2019 00:00:00+00","-6791","1733710.5","[expenditure, material-supply]"
"1","20/11/2019 00:00:00+00","-300","1084981.85","[expenditure, material-supply]"
"1","20/11/2019 00:00:00+00","-510","1084471.85","[expenditure, material-supply]"
"1","20/11/2019 00:00:00+00","-2047","1082424.85","[expenditure, material-supply]"
"1","20/11/2019 00:00:00+00","-6936.5","1075488.35","[expenditure, material-supply]"
"1","20/11/2019 00:00:00+00","-10368","1065120.35","[expenditure, material-supply]"
"1","20/11/2019 00:00:00+00","-4293.71","1060826.64","[expenditure, material-supply]"
"1","20/11/2019 00:00:00+00","-842","1059984.64","[expenditure]"
"1","20/11/2019 00:00:00+00","-2429","1057555.64","[expenditure]"
"1","20/11/2019 00:00:00+00","1180","1058735.64","[revenue]"
"1","20/11/2019 00:00:00+00","9524","1068259.64","[revenue, sales]"
"1","20/11/2019 00:00:00+00","7609.68","1075869.32","[revenue, sales]"
"1","20/11/2019 00:00:00+00","5028.67","1080897.99","[revenue, sales]"
"1","20/11/2019 00:00:00+00","8610","1089507.99","[revenue, sales]"
"1","20/11/2019 00:00:00+00","2650","1092157.99","[revenue, sales]"
"1","20/11/2019 00:00:00+00","3915.81","1096073.8","[revenue, sales]"
"1","20/11/2019 00:00:00+00","100","1096173.8","[revenue]"
"1","20/11/2019 00:00:00+00","2741.99","1098915.79","[revenue, sales]"
"1","20/11/2019 00:00:00+00","-34.99","1098880.8","[expenditure, material-supply]"
"1","20/11/2019 00:00:00+00","113","1098993.8","[revenue]"
"1","21/11/2019 00:00:00+00","-30","1098963.8","[expenditure, material-supply]"
"1","21/11/2019 00:00:00+00","-1497.5","1097466.3","[expenditure, material-supply]"
"1","21/11/2019 00:00:00+00","-7326.76","1090139.54","[expenditure, material-supply]"
"1","21/11/2019 00:00:00+00","-735.5","1089404.04","[expenditure, material-supply]"
"1","21/11/2019 00:00:00+00","-1381.5","1088022.54","[expenditure, material-supply]"
"1","21/11/2019 00:00:00+00","-643.9","1087378.64","[expenditure, material-supply]"
"1","21/11/2019 00:00:00+00","-1351.81","1086026.83","[expenditure, material-supply]"
"1","21/11/2019 00:00:00+00","-583","1085443.83","[expenditure, material-supply]"
"1","21/11/2019 00:00:00+00","-3043.68","1082400.15","[expenditure, material-supply]"
"1","21/11/2019 00:00:00+00","-9555.8","1072844.35","[expenditure, material-supply]"
"1","21/11/2019 00:00:00+00","-707.68","1072136.67","[expenditure, material-supply]"
"1","21/11/2019 00:00:00+00","-3351.66","1068785.01","[expenditure, material-supply]"
"1","21/11/2019 00:00:00+00","-707.5","1068077.51","[expenditure, material-supply]"
"1","21/11/2019 00:00:00+00","-1090","1066987.51","[expenditure, material-supply]"
"1","21/11/2019 00:00:00+00","-868.51","1066119","[expenditure, material-supply]"
"1","21/11/2019 00:00:00+00","-1790.01","1064328.99","[expenditure, material-supply]"
"1","21/11/2019 00:00:00+00","-714","1063614.99","[expenditure, material-supply]"
"1","21/11/2019 00:00:00+00","-385.97","1063229.02","[expenditure, material-supply]"
"1","21/11/2019 00:00:00+00","-1134.97","1062094.05","[expenditure, material-supply]"
"1","21/11/2019 00:00:00+00","-5950","1056144.05","[expenditure, material-supply]"
"1","21/11/2019 00:00:00+00","-131.85","1733578.65","[expenditure, material-supply]"
"1","21/11/2019 00:00:00+00","-3648.16","1729930.49","[expenditure, material-supply]"
"1","21/11/2019 00:00:00+00","-6069","1723861.49","[expenditure, material-supply]"
"1","21/11/2019 00:00:00+00","-128.77","1056015.28","[expenditure, material-supply]"
"1","21/11/2019 00:00:00+00","-218.53","1055796.75","[expenditure, material-supply]"
"1","21/11/2019 00:00:00+00","-105.91","1055690.84","[expenditure, material-supply]"
"1","21/11/2019 00:00:00+00","-28.39","1055662.45","[expenditure, material-supply]"
"1","21/11/2019 00:00:00+00","-97.1","1055565.35","[expenditure, material-supply]"
"1","21/11/2019 00:00:00+00","-6069","1049496.35","[expenditure, material-supply]"
"1","21/11/2019 00:00:00+00","-2748.9","1046747.45","[expenditure, material-supply]"
"1","21/11/2019 00:00:00+00","-56.47","1046690.98","[expenditure, material-supply]"
"1","21/11/2019 00:00:00+00","-75.1","1046615.88","[expenditure, material-supply]"
"1","21/11/2019 00:00:00+00","-0.26","1046615.62","[expenditure, material-supply]"
"1","21/11/2019 00:00:00+00","294","1046909.62","[revenue, sales]"
"1","21/11/2019 00:00:00+00","1920","1048829.62","[revenue, sales]"
"1","21/11/2019 00:00:00+00","9410","1058239.62","[revenue]"
"1","21/11/2019 00:00:00+00","3047.68","1061287.3","[revenue, sales]"
"1","21/11/2019 00:00:00+00","1428.6","1062715.9","[revenue, sales]"
"1","21/11/2019 00:00:00+00","4524.51","1067240.41","[revenue, sales]"
"1","21/11/2019 00:00:00+00","5621.71","1072862.12","[revenue, sales]"
"1","21/11/2019 00:00:00+00","7310","1080172.12","[revenue, sales]"
"1","21/11/2019 00:00:00+00","3690","1083862.12","[revenue, sales]"
"1","21/11/2019 00:00:00+00","100","1083962.12","[revenue, sales]"
"1","21/11/2019 00:00:00+00","30","1083992.12","[revenue]"
"1","21/11/2019 00:00:00+00","3190","1087182.12","[revenue, sales]"
"1","21/11/2019 00:00:00+00","13864.05","1101046.17","[revenue, sales]"
"1","21/11/2019 00:00:00+00","9810","1733671.49","[revenue]"
"1","21/11/2019 00:00:00+00","-4","1733667.49","[expenditure, credit-card]"
"1","21/11/2019 00:00:00+00","-47.6","1733619.89","[expenditure, material-supply, cash]"
"1","21/11/2019 00:00:00+00","-120","1733499.89","[expenditure, credit, material-supply]"
"1","21/11/2019 00:00:00+00","-95.2","1733404.69","[expenditure, credit, material-supply]"
"1","22/11/2019 00:00:00+00","-22397.05","1711007.64","[expenditure, material-supply]"
"1","22/11/2019 00:00:00+00","-901.44","1710106.2","[expenditure, material-supply]"
"1","22/11/2019 00:00:00+00","-5679.72","1704426.48","[expenditure, material-supply]"
"1","22/11/2019 00:00:00+00","-2526","1098520.17","[expenditure, material-supply]"
"1","22/11/2019 00:00:00+00","-3663.22","1094856.95","[expenditure, material-supply]"
"1","22/11/2019 00:00:00+00","-1567.71","1093289.24","[expenditure, material-supply]"
"1","22/11/2019 00:00:00+00","-6008","1087281.24","[expenditure, material-supply]"
"1","22/11/2019 00:00:00+00","-1130.89","1086150.35","[expenditure, material-supply]"
"1","22/11/2019 00:00:00+00","-1319.46","1084830.89","[expenditure, material-supply]"
"1","22/11/2019 00:00:00+00","-2856.67","1081974.22","[expenditure, material-supply]"
"1","22/11/2019 00:00:00+00","-633.46","1081340.76","[expenditure, material-supply]"
"1","22/11/2019 00:00:00+00","-4631.3","1076709.46","[expenditure, material-supply]"
"1","22/11/2019 00:00:00+00","-3285.45","1073424.01","[expenditure, rent]"
"1","22/11/2019 00:00:00+00","-473.35","1072950.66","[expenditure]"
"1","22/11/2019 00:00:00+00","100","1073050.66","[revenue]"
"1","22/11/2019 00:00:00+00","1352.41","1074403.07","[revenue, sales]"
"1","22/11/2019 00:00:00+00","3952.46","1078355.53","[revenue, sales]"
"1","22/11/2019 00:00:00+00","5133.44","1083488.97","[revenue, sales]"
"1","22/11/2019 00:00:00+00","9714.48","1093203.45","[revenue, sales]"
"1","22/11/2019 00:00:00+00","2166.71","1095370.16","[revenue, sales]"
"1","22/11/2019 00:00:00+00","4752.48","1100122.64","[revenue, sales]"
"1","22/11/2019 00:00:00+00","100","1100222.64","[revenue]"
"1","22/11/2019 00:00:00+00","14260","1114482.64","[revenue, sales]"
"1","22/11/2019 00:00:00+00","21510","1135992.64","[revenue]"
"1","22/11/2019 00:00:00+00","100","1136092.64","[revenue, sales]"
"1","22/11/2019 00:00:00+00","100","1136192.64","[revenue]"
"1","22/11/2019 00:00:00+00","2253.87","1138446.51","[revenue, sales]"
"1","22/11/2019 00:00:00+00","3540","1141986.51","[revenue]"
"1","22/11/2019 00:00:00+00","4740","1146726.51","[revenue, sales]"
"1","22/11/2019 00:00:00+00","17249.13","1163975.64","[revenue, sales]"
"1","22/11/2019 00:00:00+00","113.5","1164089.14","[revenue, sales]"
"1","22/11/2019 00:00:00+00","-27.86","1164061.28","[expenditure]"
"1","22/11/2019 00:00:00+00","-4","1164057.28","[expenditure, credit-card]"
"1","22/11/2019 00:00:00+00","-4","1164053.28","[expenditure]"
"1","22/11/2019 00:00:00+00","-505.98","1163547.3","[expenditure, material-supply]"
"1","25/11/2019 00:00:00+00","-6358","1157189.3","[expenditure, material-supply]"
"1","25/11/2019 00:00:00+00","-24500.46","1132688.84","[expenditure, material-supply]"
"1","25/11/2019 00:00:00+00","-8359.03","1124329.81","[expenditure, material-supply]"
"1","25/11/2019 00:00:00+00","-11181","1113148.81","[expenditure, material-supply]"
"1","25/11/2019 00:00:00+00","-6500","1106648.81","[expenditure, material-supply]"
"1","25/11/2019 00:00:00+00","-1594.5","1105054.31","[expenditure, material-supply]"
"1","25/11/2019 00:00:00+00","-1216.99","1103837.32","[expenditure, material-supply]"
"1","25/11/2019 00:00:00+00","-689.2","1103148.12","[expenditure, material-supply]"
"1","25/11/2019 00:00:00+00","-1589.7","1101558.42","[expenditure, material-supply]"
"1","25/11/2019 00:00:00+00","-682.5","1100875.92","[expenditure, material-supply]"
"1","25/11/2019 00:00:00+00","-1320","1099555.92","[expenditure, material-supply]"
"1","25/11/2019 00:00:00+00","-610.73","1098945.19","[expenditure, material-supply]"
"1","25/11/2019 00:00:00+00","-2620.5","1096324.69","[expenditure, material-supply]"
"1","25/11/2019 00:00:00+00","-427","1095897.69","[expenditure, material-supply]"
"1","25/11/2019 00:00:00+00","-268.3","1095629.39","[expenditure, material-supply]"
"1","25/11/2019 00:00:00+00","-5138","1090491.39","[expenditure, material-supply]"
"1","25/11/2019 00:00:00+00","-1357.51","1089133.88","[expenditure, material-supply]"
"1","25/11/2019 00:00:00+00","-100","1089033.88","[expenditure, credit, material-supply]"
"1","25/11/2019 00:00:00+00","-803.69","1088230.19","[expenditure, material-supply]"
"1","25/11/2019 00:00:00+00","-854.97","1087375.22","[expenditure]"
"1","25/11/2019 00:00:00+00","-0.14","1087375.08","[expenditure, material-supply]"
"1","25/11/2019 00:00:00+00","-176581.93","910793.15","[expenditure]"
"1","25/11/2019 00:00:00+00","-93621.46","817171.69","[expenditure]"
"1","25/11/2019 00:00:00+00","-49404.14","767767.55","[expenditure, tax, salary-extra-costs, salary, material-supply]"
"1","25/11/2019 00:00:00+00","7160","774927.55","[revenue, sales]"
"1","25/11/2019 00:00:00+00","11930","786857.55","[revenue]"
"1","25/11/2019 00:00:00+00","5380","792237.55","[revenue]"
"1","25/11/2019 00:00:00+00","180","792417.55","[revenue, sales]"
"1","25/11/2019 00:00:00+00","100","792517.55","[revenue, sales]"
"1","25/11/2019 00:00:00+00","3980","796497.55","[revenue]"
"1","25/11/2019 00:00:00+00","10730","807227.55","[revenue, sales]"
"1","25/11/2019 00:00:00+00","4642.76","811870.31","[revenue, sales]"
"1","25/11/2019 00:00:00+00","4930","816800.31","[revenue, sales]"
"1","25/11/2019 00:00:00+00","3350","820150.31","[revenue]"
"1","25/11/2019 00:00:00+00","9934.89","830085.2","[revenue, sales]"
"1","25/11/2019 00:00:00+00","-16.55","830068.65","[expenditure, credit-card]"
"1","25/11/2019 00:00:00+00","-4","830064.65","[expenditure]"
"1","25/11/2019 00:00:00+00","-52.6","830012.05","[expenditure, material-supply]"
"1","25/11/2019 00:00:00+00","-333.02","829679.03","[expenditure, material-supply]"
"1","26/11/2019 00:00:00+00","-1027.5","1703398.98","[expenditure, material-supply]"
"1","26/11/2019 00:00:00+00","-300","829379.03","[expenditure, material-supply]"
"1","26/11/2019 00:00:00+00","-10256.96","819122.07","[expenditure, material-supply]"
"1","26/11/2019 00:00:00+00","-9714.48","809407.59","[expenditure, material-supply]"
"1","26/11/2019 00:00:00+00","-142","809265.59","[expenditure, material-supply]"
"1","26/11/2019 00:00:00+00","7930","817195.59","[revenue]"
"1","26/11/2019 00:00:00+00","9143.04","826338.63","[revenue, sales]"
"1","26/11/2019 00:00:00+00","1857.18","828195.81","[revenue, sales]"
"1","26/11/2019 00:00:00+00","6133.46","834329.27","[revenue, sales]"
"1","26/11/2019 00:00:00+00","3142.92","837472.19","[revenue, sales]"
"1","26/11/2019 00:00:00+00","1170","838642.19","[revenue]"
"1","26/11/2019 00:00:00+00","11570","850212.19","[revenue, sales]"
"1","26/11/2019 00:00:00+00","3855.22","854067.41","[revenue, sales]"
"1","26/11/2019 00:00:00+00","2664.5","856731.91","[revenue, sales]"
"1","26/11/2019 00:00:00+00","870","857601.91","[revenue]"
"1","26/11/2019 00:00:00+00","11000","868601.91","[revenue, sales]"
"1","26/11/2019 00:00:00+00","26111.51","894713.42","[revenue, sales]"
"1","26/11/2019 00:00:00+00","113.83","894827.25","[revenue, sales]"
"1","26/11/2019 00:00:00+00","3285.45","898112.7","[revenue, chargeback, rent]"
"1","26/11/2019 00:00:00+00","-25.22","898087.48","[expenditure]"
"1","26/11/2019 00:00:00+00","-4","898083.48","[expenditure, credit-card]"
"1","26/11/2019 00:00:00+00","-320","897763.48","[expenditure, credit, material-supply]"
"1","26/11/2019 00:00:00+00","-10","897753.48","[expenditure, credit, material-supply]"
"1","26/11/2019 00:00:00+00","-10","897743.48","[expenditure, credit, material-supply]"
"1","26/11/2019 00:00:00+00","-10","897733.48","[expenditure, administration, credit, material-supply]"
"1","26/11/2019 00:00:00+00","-10","897723.48","[expenditure, administration, credit, material-supply]"
"1","26/11/2019 00:00:00+00","-75","897648.48","[expenditure, credit, material-supply]"
"1","26/11/2019 00:00:00+00","-87.5","897560.98","[expenditure, credit, material-supply]"
"1","26/11/2019 00:00:00+00","-40","897520.98","[expenditure, credit, material-supply]"
"1","26/11/2019 00:00:00+00","49110","946630.98","[revenue, deposit]"
"1","27/11/2019 00:00:00+00","-604.6","946026.38","[expenditure, material-supply]"
"1","27/11/2019 00:00:00+00","-3178","942848.38","[expenditure, material-supply]"
"1","27/11/2019 00:00:00+00","-412.79","942435.59","[expenditure, material-supply]"
"1","27/11/2019 00:00:00+00","-2873.5","939562.09","[expenditure, material-supply]"
"1","27/11/2019 00:00:00+00","-929.95","938632.14","[expenditure, material-supply]"
"1","27/11/2019 00:00:00+00","-1250","937382.14","[expenditure, material-supply]"
"1","27/11/2019 00:00:00+00","-811.6","936570.54","[expenditure, material-supply]"
"1","27/11/2019 00:00:00+00","-1180","935390.54","[expenditure, material-supply]"
"1","27/11/2019 00:00:00+00","-21510","913880.54","[expenditure, material-supply]"
"1","27/11/2019 00:00:00+00","-1362.9","912517.64","[expenditure, material-supply]"
"1","27/11/2019 00:00:00+00","-421.9","912095.74","[expenditure, material-supply]"
"1","27/11/2019 00:00:00+00","-2024.4","910071.34","[expenditure, material-supply]"
"1","27/11/2019 00:00:00+00","-3615","906456.34","[expenditure, material-supply]"
"1","27/11/2019 00:00:00+00","-947.5","905508.84","[expenditure, material-supply]"
"1","27/11/2019 00:00:00+00","-2238","903270.84","[expenditure, material-supply]"
"1","27/11/2019 00:00:00+00","-1128.5","902142.34","[expenditure, material-supply]"
"1","27/11/2019 00:00:00+00","-1335","1702063.98","[expenditure, material-supply]"
"1","27/11/2019 00:00:00+00","-3125","1698938.98","[expenditure, material-supply]"
"1","27/11/2019 00:00:00+00","-3285.45","1695653.53","[expenditure, material-supply]"
"1","27/11/2019 00:00:00+00","-0.48","1695653.05","[expenditure, material-supply]"
"1","27/11/2019 00:00:00+00","-0.06","1695652.99","[expenditure, material-supply]"
"1","27/11/2019 00:00:00+00","-128260.23","1567392.76","[expenditure, material-supply]"
"1","27/11/2019 00:00:00+00","-1173.06","1566219.7","[expenditure, material-supply]"
"1","27/11/2019 00:00:00+00","-44129.82","1522089.88","[expenditure, material-supply]"
"1","27/11/2019 00:00:00+00","-33184.84","1488905.04","[expenditure, material-supply]"
"1","27/11/2019 00:00:00+00","-9190.01","1479715.03","[expenditure, material-supply]"
"1","27/11/2019 00:00:00+00","-2.42","902139.92","[expenditure, material-supply]"
"1","27/11/2019 00:00:00+00","-792.24","901347.68","[expenditure, material-supply]"
"1","27/11/2019 00:00:00+00","-14263.36","887084.32","[expenditure, material-supply]"
"1","27/11/2019 00:00:00+00","-23953.12","863131.2","[expenditure, material-supply]"
"1","27/11/2019 00:00:00+00","-43.91","863087.29","[expenditure, material-supply]"
"1","27/11/2019 00:00:00+00","-122.4","862964.89","[expenditure, material-supply]"
"1","27/11/2019 00:00:00+00","-319.99","1479395.04","[expenditure, material-supply]"
"1","27/11/2019 00:00:00+00","-56.93","862907.96","[expenditure, material-supply]"
"1","27/11/2019 00:00:00+00","-84.42","862823.54","[expenditure, material-supply]"
"1","27/11/2019 00:00:00+00","-2320","860503.54","[expenditure, material-supply]"
"1","27/11/2019 00:00:00+00","-651.57","859851.97","[expenditure, material-supply]"
"1","27/11/2019 00:00:00+00","-11465.94","848386.03","[expenditure, material-supply]"
"1","27/11/2019 00:00:00+00","-5320.44","843065.59","[expenditure, material-supply]"
"1","27/11/2019 00:00:00+00","-611.07","842454.52","[expenditure, material-supply]"
"1","27/11/2019 00:00:00+00","-74977.2","767477.32","[expenditure, material-supply]"
"1","27/11/2019 00:00:00+00","-998.13","766479.19","[expenditure, material-supply]"
"1","27/11/2019 00:00:00+00","-164.55","766314.64","[expenditure, material-supply]"
"1","27/11/2019 00:00:00+00","-1291.15","765023.49","[expenditure, material-supply]"
"1","27/11/2019 00:00:00+00","-1288.18","763735.31","[expenditure, material-supply]"
"1","27/11/2019 00:00:00+00","5282.7","769018.01","[revenue]"
"1","27/11/2019 00:00:00+00","9700","778718.01","[revenue]"
"1","27/11/2019 00:00:00+00","100","778818.01","[revenue]"
"1","27/11/2019 00:00:00+00","8250","787068.01","[revenue, sales]"
"1","27/11/2019 00:00:00+00","2295.28","789363.29","[revenue, sales]"
"1","27/11/2019 00:00:00+00","100","789463.29","[revenue]"
"1","27/11/2019 00:00:00+00","3290","792753.29","[revenue]"
"1","27/11/2019 00:00:00+00","2428.74","795182.03","[revenue, sales]"
"1","27/11/2019 00:00:00+00","10018.53","805200.56","[revenue, sales]"
"1","27/11/2019 00:00:00+00","5180","810380.56","[revenue, sales]"
"1","27/11/2019 00:00:00+00","3245.84","813626.4","[revenue, sales]"
"1","27/11/2019 00:00:00+00","100","813726.4","[revenue]"
"1","27/11/2019 00:00:00+00","-4","813722.4","[expenditure, credit-card]"
"1","28/11/2019 00:00:00+00","-1935.5","811786.9","[expenditure, material-supply]"
"1","28/11/2019 00:00:00+00","-1187.8","810599.1","[expenditure, material-supply]"
"1","28/11/2019 00:00:00+00","-0.11","810598.99","[expenditure, material-supply]"
"1","28/11/2019 00:00:00+00","-0.3","810598.69","[expenditure, material-supply]"
"1","28/11/2019 00:00:00+00","-16156","794442.69","[expenditure, material-supply]"
"1","28/11/2019 00:00:00+00","-1541.2","792901.49","[expenditure, material-supply]"
"1","28/11/2019 00:00:00+00","-1613.7","791287.79","[expenditure, material-supply]"
"1","28/11/2019 00:00:00+00","-3995","787292.79","[expenditure, material-supply]"
"1","28/11/2019 00:00:00+00","-0.43","787292.36","[expenditure, material-supply]"
"1","28/11/2019 00:00:00+00","-7416.9","779875.46","[expenditure, material-supply]"
"1","28/11/2019 00:00:00+00","-27706","752169.46","[expenditure, material-supply]"
"1","28/11/2019 00:00:00+00","2630","754799.46","[revenue, sales]"
"1","28/11/2019 00:00:00+00","4742.95","759542.41","[revenue, sales]"
"1","28/11/2019 00:00:00+00","4714.38","764256.79","[revenue, sales]"
"1","28/11/2019 00:00:00+00","4609.62","768866.41","[revenue, sales]"
"1","28/11/2019 00:00:00+00","4476.28","773342.69","[revenue, sales]"
"1","28/11/2019 00:00:00+00","3220","776562.69","[revenue]"
"1","28/11/2019 00:00:00+00","8588.02","785150.71","[revenue, sales]"
"1","28/11/2019 00:00:00+00","23810","808960.71","[revenue, sales]"
"1","28/11/2019 00:00:00+00","9207.98","818168.69","[revenue, sales]"
"1","28/11/2019 00:00:00+00","100","818268.69","[revenue]"
"1","28/11/2019 00:00:00+00","112.7","818381.39","[revenue, sales]"
"1","28/11/2019 00:00:00+00","-488","1478907.04","[expenditure, material-supply]"
"1","28/11/2019 00:00:00+00","-4","1478903.04","[expenditure, credit-card]"
"1","28/11/2019 00:00:00+00","-1.5","1478901.54","[expenditure, material-supply]"
"1","28/11/2019 00:00:00+00","-4","1478897.54","[expenditure, material-supply]"
"1","29/11/2019 00:00:00+00","-2801.02","1476096.52","[expenditure, material-supply]"
"1","29/11/2019 00:00:00+00","-1964.99","1474131.53","[expenditure, material-supply]"
"1","29/11/2019 00:00:00+00","-2630.2","1471501.33","[expenditure, material-supply]"
"1","29/11/2019 00:00:00+00","-2161.34","1469339.99","[expenditure, material-supply]"
"1","29/11/2019 00:00:00+00","-2360.5","1466979.49","[expenditure, material-supply]"
"1","29/11/2019 00:00:00+00","-1206.49","1465773","[expenditure, material-supply]"
"1","29/11/2019 00:00:00+00","-500.7","817880.69","[expenditure, material-supply]"
"1","29/11/2019 00:00:00+00","-557.5","1465215.5","[expenditure, material-supply]"
"1","29/11/2019 00:00:00+00","-1541","816339.69","[expenditure, material-supply]"
"1","29/11/2019 00:00:00+00","-304.14","816035.55","[expenditure]"
"1","29/11/2019 00:00:00+00","-0.2","816035.35","[expenditure, material-supply]"
"1","29/11/2019 00:00:00+00","-0.45","816034.9","[expenditure, material-supply]"
"1","29/11/2019 00:00:00+00","-0.49","1465215.01","[expenditure, material-supply]"
"1","29/11/2019 00:00:00+00","-300","1464915.01","[expenditure, material-supply]"
"1","29/11/2019 00:00:00+00","-150","1464765.01","[expenditure, material-supply]"
"1","29/11/2019 00:00:00+00","1650","817684.9","[revenue, sales]"
"1","29/11/2019 00:00:00+00","7143","824827.9","[revenue, sales]"
"1","29/11/2019 00:00:00+00","1419.08","826246.98","[revenue, sales]"
"1","29/11/2019 00:00:00+00","18571.8","844818.78","[revenue, sales]"
"1","29/11/2019 00:00:00+00","100","844918.78","[revenue]"
"1","29/11/2019 00:00:00+00","4260","849178.78","[revenue]"
"1","29/11/2019 00:00:00+00","2399.59","851578.37","[revenue, sales]"
"1","29/11/2019 00:00:00+00","1851.29","853429.66","[revenue, sales]"
"1","29/11/2019 00:00:00+00","23320.41","876750.07","[revenue, sales]"
"1","29/11/2019 00:00:00+00","10342.01","887092.08","[revenue, sales]"
"1","29/11/2019 00:00:00+00","3759.37","890851.45","[revenue, sales]"
"1","29/11/2019 00:00:00+00","3052.87","893904.32","[revenue, sales]"
"1","29/11/2019 00:00:00+00","5760","1470525.01","[revenue]"
"1","29/11/2019 00:00:00+00","5840","1476365.01","[revenue]"
"1","29/11/2019 00:00:00+00","2420","1478785.01","[revenue]"
"1","29/11/2019 00:00:00+00","41444.76","1520229.77","[revenue, sales]"
"1","29/11/2019 00:00:00+00","83697.42","977601.74","[revenue, sales]"
"1","29/11/2019 00:00:00+00","114.23","977715.97","[revenue, sales]"
"1","29/11/2019 00:00:00+00","-57.91","977658.06","[expenditure]"
"1","29/11/2019 00:00:00+00","-19","977639.06","[expenditure]"
"1","29/11/2019 00:00:00+00","-442.01","977197.05","[expenditure, material-supply]"
"1","29/11/2019 00:00:00+00","-125.9","977071.15","[expenditure]"
"1","29/11/2019 00:00:00+00","-821.75","976249.4","[expenditure]"
"1","2/12/2019 00:00:00+00","-7552","968697.4","[expenditure, material-supply]"
"1","2/12/2019 00:00:00+00","-1348.07","967349.33","[expenditure, material-supply]"
"1","2/12/2019 00:00:00+00","-1492.5","965856.83","[expenditure, material-supply]"
"1","2/12/2019 00:00:00+00","-728.69","965128.14","[expenditure, material-supply]"
"1","2/12/2019 00:00:00+00","-9990","955138.14","[expenditure, material-supply]"
"1","2/12/2019 00:00:00+00","-13894.33","941243.81","[expenditure, material-supply]"
"1","2/12/2019 00:00:00+00","-1913","939330.81","[expenditure, material-supply]"
"1","2/12/2019 00:00:00+00","-990","938340.81","[expenditure, material-supply]"
"1","2/12/2019 00:00:00+00","-544.01","937796.8","[expenditure, material-supply]"
"1","2/12/2019 00:00:00+00","-3752.6","934044.2","[expenditure, material-supply]"
"1","2/12/2019 00:00:00+00","-737.5","933306.7","[expenditure, material-supply]"
"1","2/12/2019 00:00:00+00","-3075.96","930230.74","[expenditure, salary, material-supply]"
"1","2/12/2019 00:00:00+00","-1833.22","928397.52","[expenditure, material-supply]"
"1","2/12/2019 00:00:00+00","-468.5","1519761.27","[expenditure, material-supply]"
"1","2/12/2019 00:00:00+00","-1608.69","1518152.58","[expenditure, material-supply]"
"1","2/12/2019 00:00:00+00","-1516","1516636.58","[expenditure, material-supply]"
"1","2/12/2019 00:00:00+00","-0.07","1516636.51","[expenditure, material-supply]"
"1","2/12/2019 00:00:00+00","-0.12","1516636.39","[expenditure, material-supply]"
"1","2/12/2019 00:00:00+00","-0.23","1516636.16","[expenditure, material-supply]"
"1","2/12/2019 00:00:00+00","-0.19","1516635.97","[expenditure, material-supply]"
"1","2/12/2019 00:00:00+00","-154","1516481.97","[expenditure, material-supply]"
"1","2/12/2019 00:00:00+00","-11502.82","1504979.15","[expenditure, material-supply]"
"1","2/12/2019 00:00:00+00","-499.28","1504479.87","[expenditure]"
"1","2/12/2019 00:00:00+00","-141.61","1504338.26","[expenditure, material-supply]"
"1","2/12/2019 00:00:00+00","-889.53","1503448.73","[expenditure, material-supply]"
"1","2/12/2019 00:00:00+00","1930","930327.52","[revenue]"
"1","2/12/2019 00:00:00+00","50","930377.52","[revenue]"
"1","2/12/2019 00:00:00+00","14.66","930392.18","[revenue]"
"1","2/12/2019 00:00:00+00","18.68","930410.86","[revenue]"
"1","2/12/2019 00:00:00+00","28.56","930439.42","[revenue]"
"1","2/12/2019 00:00:00+00","7.61","930447.03","[revenue]"
"1","2/12/2019 00:00:00+00","25.09","930472.12","[revenue]"
"1","2/12/2019 00:00:00+00","5500","935972.12","[revenue]"
"1","2/12/2019 00:00:00+00","7390","943362.12","[revenue]"
"1","2/12/2019 00:00:00+00","10490","953852.12","[revenue]"
"1","2/12/2019 00:00:00+00","2700","956552.12","[revenue]"
"1","2/12/2019 00:00:00+00","9350","965902.12","[revenue]"
"1","2/12/2019 00:00:00+00","13619.32","979521.44","[revenue, sales]"
"1","2/12/2019 00:00:00+00","2640","982161.44","[revenue]"
"1","2/12/2019 00:00:00+00","16430","998591.44","[revenue, sales]"
"1","2/12/2019 00:00:00+00","5329","1003920.44","[revenue, sales]"
"1","2/12/2019 00:00:00+00","3290","1007210.44","[revenue, sales]"
"1","2/12/2019 00:00:00+00","6460","1013670.44","[revenue]"
"1","2/12/2019 00:00:00+00","2802.33","1016472.77","[revenue, sales]"
"1","2/12/2019 00:00:00+00","-4","1016468.77","[expenditure]"
"1","2/12/2019 00:00:00+00","-53.55","1016415.22","[expenditure, material-supply]"
"1","2/12/2019 00:00:00+00","-1","1016414.22","[expenditure]"
"1","2/12/2019 00:00:00+00","-1.3","1016412.92","[expenditure]"
"1","2/12/2019 00:00:00+00","-6.55","1503442.18","[expenditure]"
"1","2/12/2019 00:00:00+00","-104.65","1016308.27","[expenditure]"
"1","3/12/2019 00:00:00+00","-29.9","1016278.37","[expenditure]"
"1","3/12/2019 00:00:00+00","-0.1","1016278.27","[expenditure, material-supply]"
"1","3/12/2019 00:00:00+00","-0.24","1016278.03","[expenditure, material-supply]"
"1","3/12/2019 00:00:00+00","-0.16","1016277.87","[expenditure, material-supply]"
"1","3/12/2019 00:00:00+00","-75964.28","940313.59","[expenditure, material-supply]"
"1","3/12/2019 00:00:00+00","4820","945133.59","[revenue]"
"1","3/12/2019 00:00:00+00","100","945233.59","[revenue]"
"1","3/12/2019 00:00:00+00","9047.8","954281.39","[revenue, sales]"
"1","3/12/2019 00:00:00+00","2095.28","956376.67","[revenue, sales]"
"1","3/12/2019 00:00:00+00","7730","964106.67","[revenue]"
"1","3/12/2019 00:00:00+00","50","964156.67","[revenue]"
"1","3/12/2019 00:00:00+00","2300","966456.67","[revenue]"
"1","3/12/2019 00:00:00+00","50","966506.67","[revenue, sales]"
"1","3/12/2019 00:00:00+00","6373.01","972879.68","[revenue, sales]"
"1","3/12/2019 00:00:00+00","4210","977089.68","[revenue]"
"1","3/12/2019 00:00:00+00","12930","990019.68","[revenue]"
"1","3/12/2019 00:00:00+00","3750","993769.68","[revenue]"
"1","3/12/2019 00:00:00+00","14958.11","1008727.79","[revenue, sales]"
"1","3/12/2019 00:00:00+00","-19.56","1008708.23","[expenditure]"
"1","3/12/2019 00:00:00+00","-3","1008705.23","[expenditure]"
"1","3/12/2019 00:00:00+00","-19","1008686.23","[expenditure]"
"1","3/12/2019 00:00:00+00","-19","1008667.23","[expenditure]"
"1","3/12/2019 00:00:00+00","-6316.63","1002350.6","[expenditure]"
"1","4/12/2019 00:00:00+00","-2920","999430.6","[expenditure]"
"1","4/12/2019 00:00:00+00","-0.03","999430.57","[expenditure, material-supply]"
"1","4/12/2019 00:00:00+00","-0.14","999430.43","[expenditure, material-supply]"
"1","4/12/2019 00:00:00+00","-0.35","999430.08","[expenditure, material-supply]"
"1","4/12/2019 00:00:00+00","-105","999325.08","[expenditure, material-supply]"
"1","4/12/2019 00:00:00+00","-2959.99","996365.09","[expenditure]"
"1","4/12/2019 00:00:00+00","-70","996295.09","[expenditure, material-supply]"
"1","4/12/2019 00:00:00+00","-25584.59","970710.5","[expenditure, material-supply]"
"1","4/12/2019 00:00:00+00","-18594.17","952116.33","[expenditure]"
"1","4/12/2019 00:00:00+00","-3285.45","948830.88","[expenditure]"
"1","4/12/2019 00:00:00+00","-6760.28","942070.6","[expenditure, material-supply]"
"1","4/12/2019 00:00:00+00","-1255.5","940815.1","[expenditure, material-supply]"
"1","4/12/2019 00:00:00+00","-1496","939319.1","[expenditure, material-supply]"
"1","4/12/2019 00:00:00+00","-5855.3","933463.8","[expenditure, material-supply]"
"1","4/12/2019 00:00:00+00","-968.4","932495.4","[expenditure, material-supply]"
"1","4/12/2019 00:00:00+00","-2771.4","929724","[expenditure, material-supply]"
"1","4/12/2019 00:00:00+00","-3000","926724","[expenditure, material-supply]"
"1","4/12/2019 00:00:00+00","-1031.49","925692.51","[expenditure, material-supply]"
"1","4/12/2019 00:00:00+00","-2055","923637.51","[expenditure, material-supply]"
"1","4/12/2019 00:00:00+00","-5740.3","917897.21","[expenditure, material-supply]"
"1","4/12/2019 00:00:00+00","-8019.61","909877.6","[expenditure, material-supply]"
"1","4/12/2019 00:00:00+00","-3264.5","906613.1","[expenditure, material-supply]"
"1","4/12/2019 00:00:00+00","-17176.03","889437.07","[expenditure, material-supply]"
"1","4/12/2019 00:00:00+00","-1176.13","888260.94","[expenditure, material-supply]"
"1","4/12/2019 00:00:00+00","-921.11","887339.83","[expenditure]"
"1","4/12/2019 00:00:00+00","2950","890289.83","[revenue]"
"1","4/12/2019 00:00:00+00","2400","1505842.18","[revenue, sales]"
"1","4/12/2019 00:00:00+00","50","1505892.18","[revenue, sales]"
"1","4/12/2019 00:00:00+00","100","1505992.18","[revenue, sales]"
"1","4/12/2019 00:00:00+00","11400","1517392.18","[revenue]"
"1","4/12/2019 00:00:00+00","1180.98","1518573.16","[revenue, sales]"
"1","4/12/2019 00:00:00+00","7580","1526153.16","[revenue]"
"1","4/12/2019 00:00:00+00","7540","897829.83","[revenue]"
"1","4/12/2019 00:00:00+00","1986.85","899816.68","[revenue, sales]"
"1","4/12/2019 00:00:00+00","9977.25","909793.93","[revenue, sales]"
"1","4/12/2019 00:00:00+00","3409.95","913203.88","[revenue, sales]"
"1","4/12/2019 00:00:00+00","100","913303.88","[revenue]"
"1","4/12/2019 00:00:00+00","11238.3","924542.18","[revenue, sales]"
"1","4/12/2019 00:00:00+00","-4","924538.18","[expenditure]"
"1","4/12/2019 00:00:00+00","-3","924535.18","[expenditure]"
"1","4/12/2019 00:00:00+00","-19","1526134.16","[expenditure]"
"1","4/12/2019 00:00:00+00","-279.08","924256.1","[leasing, expenditure, material-supply]"
"1","4/12/2019 00:00:00+00","-655.4","923600.7","[expenditure]"
"1","5/12/2019 00:00:00+00","-73.07","923527.63","[expenditure, material-supply]"
"1","5/12/2019 00:00:00+00","-440.3","923087.33","[expenditure, material-supply]"
"1","5/12/2019 00:00:00+00","-3286.36","919800.97","[expenditure, material-supply]"
"1","5/12/2019 00:00:00+00","-175.43","919625.54","[expenditure, material-supply]"
"1","5/12/2019 00:00:00+00","-160.65","919464.89","[expenditure, material-supply]"
"1","5/12/2019 00:00:00+00","-15113","904351.89","[expenditure, material-supply]"
"1","5/12/2019 00:00:00+00","-46.41","904305.48","[expenditure, material-supply]"
"1","5/12/2019 00:00:00+00","-5236","899069.48","[expenditure, material-supply]"
"1","5/12/2019 00:00:00+00","-5890.5","893178.98","[expenditure, material-supply]"
"1","5/12/2019 00:00:00+00","-272.51","892906.47","[expenditure, material-supply]"
"1","5/12/2019 00:00:00+00","-258.88","892647.59","[expenditure, material-supply]"
"1","5/12/2019 00:00:00+00","-19.52","892628.07","[expenditure, transport, material-supply]"
"1","5/12/2019 00:00:00+00","-297.5","892330.57","[expenditure, material-supply]"
"1","5/12/2019 00:00:00+00","-990.08","891340.49","[expenditure, material-supply]"
"1","5/12/2019 00:00:00+00","-280","891060.49","[expenditure, material-supply]"
"1","5/12/2019 00:00:00+00","-174.56","890885.93","[expenditure, material-supply]"
"1","5/12/2019 00:00:00+00","-588.34","890297.59","[expenditure, material-supply]"
"1","5/12/2019 00:00:00+00","-540.74","889756.85","[expenditure, material-supply]"
"1","5/12/2019 00:00:00+00","-0.05","889756.8","[expenditure, material-supply]"
"1","5/12/2019 00:00:00+00","-2142.6","887614.2","[expenditure, material-supply]"
"1","5/12/2019 00:00:00+00","-300","887314.2","[expenditure, material-supply]"
"1","5/12/2019 00:00:00+00","-4441.01","882873.19","[expenditure, material-supply]"
"1","5/12/2019 00:00:00+00","-1714.32","881158.87","[expenditure, material-supply]"
"1","5/12/2019 00:00:00+00","-1330.5","879828.37","[expenditure, material-supply]"
"1","5/12/2019 00:00:00+00","-12169.23","867659.14","[expenditure, material-supply]"
"1","5/12/2019 00:00:00+00","-300","867359.14","[expenditure, material-supply]"
"1","5/12/2019 00:00:00+00","-2057.32","865301.82","[expenditure, material-supply]"
"1","5/12/2019 00:00:00+00","-1850.3","863451.52","[expenditure, material-supply]"
"1","5/12/2019 00:00:00+00","-1040","862411.52","[expenditure, material-supply]"
"1","5/12/2019 00:00:00+00","-4446","857965.52","[expenditure, material-supply]"
"1","5/12/2019 00:00:00+00","-15012.15","842953.37","[expenditure, material-supply]"
"1","5/12/2019 00:00:00+00","30","842983.37","[revenue]"
"1","5/12/2019 00:00:00+00","2064.28","845047.65","[revenue, sales]"
"1","5/12/2019 00:00:00+00","3104.82","848152.47","[revenue, sales]"
"1","5/12/2019 00:00:00+00","1114.31","849266.78","[revenue, sales]"
"1","5/12/2019 00:00:00+00","2228.62","851495.4","[revenue, sales]"
"1","5/12/2019 00:00:00+00","100","851595.4","[revenue, sales]"
"1","5/12/2019 00:00:00+00","100","851695.4","[revenue, sales]"
"1","5/12/2019 00:00:00+00","3672.17","855367.57","[revenue, sales]"
"1","5/12/2019 00:00:00+00","27629.06","882996.63","[revenue, sales]"
"1","5/12/2019 00:00:00+00","100","883096.63","[revenue, sales]"
"1","6/12/2019 00:00:00+00","-16430","866666.63","[expenditure, material-supply]"
"1","6/12/2019 00:00:00+00","-50","866616.63","[expenditure, material-supply]"
"1","6/12/2019 00:00:00+00","-6505.97","860110.66","[expenditure, material-supply]"
"1","6/12/2019 00:00:00+00","-620","859490.66","[expenditure, material-supply]"
"1","6/12/2019 00:00:00+00","-1297.02","858193.64","[expenditure, material-supply]"
"1","6/12/2019 00:00:00+00","-5304.62","1520829.54","[expenditure, material-supply]"
"1","6/12/2019 00:00:00+00","-6182.98","1514646.56","[expenditure, material-supply]"
"1","6/12/2019 00:00:00+00","-3217.57","1511428.99","[expenditure, material-supply]"
"1","6/12/2019 00:00:00+00","-1946.54","1509482.45","[expenditure, material-supply]"
"1","6/12/2019 00:00:00+00","-4524.51","1504957.94","[expenditure, material-supply]"
"1","6/12/2019 00:00:00+00","-1655.4","1503302.54","[expenditure, material-supply]"
"1","6/12/2019 00:00:00+00","-8082.5","1495220.04","[expenditure, material-supply]"
"1","6/12/2019 00:00:00+00","-758.5","1494461.54","[expenditure, material-supply]"
"1","6/12/2019 00:00:00+00","-1478.51","1492983.03","[expenditure, material-supply]"
"1","6/12/2019 00:00:00+00","-600","1492383.03","[expenditure, material-supply]"
"1","6/12/2019 00:00:00+00","-41023.09","1451359.94","[expenditure, material-supply]"
"1","6/12/2019 00:00:00+00","-2223","1449136.94","[expenditure, material-supply]"
"1","6/12/2019 00:00:00+00","-1598.5","1447538.44","[expenditure, material-supply]"
"1","6/12/2019 00:00:00+00","-2400","1445138.44","[expenditure, material-supply]"
"1","6/12/2019 00:00:00+00","-15405.55","1429732.89","[expenditure, material-supply]"
"1","6/12/2019 00:00:00+00","-745.4","857448.24","[expenditure, material-supply]"
"1","6/12/2019 00:00:00+00","-2247","855201.24","[expenditure, material-supply]"
"1","6/12/2019 00:00:00+00","-2819.99","852381.25","[expenditure, material-supply]"
"1","6/12/2019 00:00:00+00","-4159","848222.25","[expenditure, material-supply]"
"1","6/12/2019 00:00:00+00","-524","847698.25","[expenditure, material-supply]"
"1","6/12/2019 00:00:00+00","-8460.59","839237.66","[expenditure, material-supply]"
"1","6/12/2019 00:00:00+00","-1070","838167.66","[expenditure, material-supply]"
"1","6/12/2019 00:00:00+00","-1065","837102.66","[expenditure, material-supply]"
"1","6/12/2019 00:00:00+00","-2390.59","834712.07","[expenditure, material-supply]"
"1","6/12/2019 00:00:00+00","-1000","833712.07","[expenditure, material-supply]"
"1","6/12/2019 00:00:00+00","-100","833612.07","[expenditure, material-supply]"
"1","6/12/2019 00:00:00+00","8940","842552.07","[revenue, sales]"
"1","6/12/2019 00:00:00+00","2.5","842554.57","[revenue]"
"1","6/12/2019 00:00:00+00","220000","1062554.57","[revenue, sales]"
"1","6/12/2019 00:00:00+00","1952.42","1064506.99","[revenue, sales]"
"1","6/12/2019 00:00:00+00","2038.14","1066545.13","[revenue, sales]"
"1","6/12/2019 00:00:00+00","3140","1069685.13","[revenue]"
"1","6/12/2019 00:00:00+00","3770.42","1073455.55","[revenue, sales]"
"1","6/12/2019 00:00:00+00","3371.09","1076826.64","[revenue, sales]"
"1","6/12/2019 00:00:00+00","4875.38","1081702.02","[revenue, sales]"
"1","6/12/2019 00:00:00+00","11921.9","1093623.92","[revenue, sales]"
"1","6/12/2019 00:00:00+00","3780.12","1097404.04","[revenue, sales]"
"1","6/12/2019 00:00:00+00","1750","1099154.04","[revenue]"
"1","6/12/2019 00:00:00+00","3730","1102884.04","[revenue]"
"1","6/12/2019 00:00:00+00","19530","1122414.04","[revenue, sales]"
"1","6/12/2019 00:00:00+00","6835.67","1129249.71","[revenue, sales]"
"1","6/12/2019 00:00:00+00","18140.7","1147390.41","[revenue, sales]"
"1","6/12/2019 00:00:00+00","115.17","1147505.58","[revenue, sales]"
"1","6/12/2019 00:00:00+00","-74.32","1147431.26","[expenditure]"
"1","6/12/2019 00:00:00+00","-75","1147356.26","[expenditure]"
"1","6/12/2019 00:00:00+00","-4","1147352.26","[expenditure]"
"1","6/12/2019 00:00:00+00","-500.51","1429232.38","[expenditure, material-supply]"
"1","9/12/2019 00:00:00+00","-4835.57","1424396.81","[expenditure, material-supply]"
"1","9/12/2019 00:00:00+00","-2101.49","1422295.32","[expenditure, material-supply]"
"1","9/12/2019 00:00:00+00","-711.1","1421584.22","[expenditure, material-supply]"
"1","9/12/2019 00:00:00+00","-2732.5","1418851.72","[expenditure, material-supply]"
"1","9/12/2019 00:00:00+00","-2855","1144497.26","[expenditure, material-supply]"
"1","9/12/2019 00:00:00+00","-2638.5","1141858.76","[expenditure, material-supply]"
"1","9/12/2019 00:00:00+00","-2172.5","1139686.26","[expenditure, material-supply]"
"1","9/12/2019 00:00:00+00","-10057.97","1129628.29","[expenditure, material-supply]"
"1","9/12/2019 00:00:00+00","-11109.06","1118519.23","[expenditure, material-supply]"
"1","9/12/2019 00:00:00+00","-2928.41","1115590.82","[expenditure, material-supply]"
"1","9/12/2019 00:00:00+00","-758.5","1114832.32","[expenditure, material-supply]"
"1","9/12/2019 00:00:00+00","-350","1114482.32","[expenditure, credit, material-supply]"
"1","9/12/2019 00:00:00+00","-7957.18","1106525.14","[expenditure, material-supply]"
"1","9/12/2019 00:00:00+00","-47.6","1418804.12","[expenditure]"
"1","9/12/2019 00:00:00+00","-17850","1400954.12","[expenditure, material-supply]"
"1","9/12/2019 00:00:00+00","-0.14","1400953.98","[expenditure, material-supply]"
"1","9/12/2019 00:00:00+00","-0.49","1400953.49","[expenditure, material-supply]"
"1","9/12/2019 00:00:00+00","-0.38","1106524.76","[expenditure, material-supply]"
"1","9/12/2019 00:00:00+00","-13098.34","1093426.42","[expenditure, tax]"
"1","9/12/2019 00:00:00+00","-12641.83","1080784.59","[expenditure, material-supply]"
"1","9/12/2019 00:00:00+00","3460","1084244.59","[revenue, sales]"
"1","9/12/2019 00:00:00+00","3523.88","1087768.47","[revenue, sales]"
"1","9/12/2019 00:00:00+00","1980.99","1089749.46","[revenue, sales]"
"1","9/12/2019 00:00:00+00","3142.92","1092892.38","[revenue, sales]"
"1","9/12/2019 00:00:00+00","3009.58","1095901.96","[revenue, sales]"
"1","9/12/2019 00:00:00+00","3047.68","1404001.17","[revenue, sales]"
"1","9/12/2019 00:00:00+00","11640","1415641.17","[revenue, sales]"
"1","9/12/2019 00:00:00+00","13007.48","1428648.65","[revenue, sales]"
"1","9/12/2019 00:00:00+00","2564.75","1431213.4","[revenue, sales]"
"1","9/12/2019 00:00:00+00","2407.07","1433620.47","[revenue, sales]"
"1","9/12/2019 00:00:00+00","3920","1099821.96","[revenue, sales]"
"1","9/12/2019 00:00:00+00","4293.82","1104115.78","[revenue, sales]"
"1","9/12/2019 00:00:00+00","9370","1113485.78","[revenue]"
"1","9/12/2019 00:00:00+00","100","1113585.78","[revenue, sales]"
"1","9/12/2019 00:00:00+00","18682.23","1132268.01","[revenue, sales]"
"1","9/12/2019 00:00:00+00","-4","1132264.01","[expenditure]"
"1","10/12/2019 00:00:00+00","-1013.01","1131251","[expenditure, material-supply]"
"1","10/12/2019 00:00:00+00","-3885.97","1127365.03","[expenditure, material-supply]"
"1","10/12/2019 00:00:00+00","-595","1126770.03","[expenditure, material-supply]"
"1","10/12/2019 00:00:00+00","-821.1","1125948.93","[expenditure, material-supply]"
"1","10/12/2019 00:00:00+00","-592.62","1125356.31","[expenditure, material-supply]"
"1","10/12/2019 00:00:00+00","-1037.58","1124318.73","[expenditure, material-supply]"
"1","10/12/2019 00:00:00+00","-385.56","1123933.17","[expenditure, material-supply]"
"1","10/12/2019 00:00:00+00","-545.02","1123388.15","[expenditure, material-supply]"
"1","10/12/2019 00:00:00+00","-1132.84","1122255.31","[expenditure, material-supply]"
"1","10/12/2019 00:00:00+00","-124.95","1122130.36","[expenditure, material-supply]"
"1","10/12/2019 00:00:00+00","-2238.39","1119891.97","[expenditure, material-supply]"
"1","10/12/2019 00:00:00+00","-309.16","1119582.81","[expenditure, material-supply]"
"1","10/12/2019 00:00:00+00","-168.16","1119414.65","[expenditure, material-supply]"
"1","10/12/2019 00:00:00+00","-105","1119309.65","[expenditure, material-supply]"
"1","10/12/2019 00:00:00+00","-79.77","1119229.88","[expenditure, material-supply]"
"1","10/12/2019 00:00:00+00","-51.28","1119178.6","[expenditure, administration, material-supply]"
"1","10/12/2019 00:00:00+00","-0.06","1119178.54","[expenditure, material-supply]"
"1","10/12/2019 00:00:00+00","-0.28","1119178.26","[expenditure, material-supply]"
"1","10/12/2019 00:00:00+00","-0.35","1433620.12","[expenditure, material-supply]"
"1","10/12/2019 00:00:00+00","-0.49","1119177.77","[expenditure, material-supply]"
"1","10/12/2019 00:00:00+00","-895.77","1118282","[expenditure, material-supply]"
"1","10/12/2019 00:00:00+00","1540","1119822","[revenue, sales]"
"1","10/12/2019 00:00:00+00","9333.52","1129155.52","[revenue, sales]"
"1","10/12/2019 00:00:00+00","1809.56","1130965.08","[revenue, sales]"
"1","10/12/2019 00:00:00+00","3809.6","1134774.68","[revenue, sales]"
"1","10/12/2019 00:00:00+00","14762.2","1149536.88","[revenue, sales]"
"1","10/12/2019 00:00:00+00","3070","1152606.88","[revenue]"
"1","10/12/2019 00:00:00+00","4300","1156906.88","[revenue]"
"1","10/12/2019 00:00:00+00","2000","1158906.88","[revenue]"
"1","10/12/2019 00:00:00+00","7808.29","1166715.17","[revenue, sales]"
"1","10/12/2019 00:00:00+00","9301.54","1176016.71","[revenue, sales]"
"1","10/12/2019 00:00:00+00","2661.47","1178678.18","[revenue, sales]"
"1","10/12/2019 00:00:00+00","2360.73","1181038.91","[revenue, sales]"
"1","10/12/2019 00:00:00+00","12060","1193098.91","[revenue, sales]"
"1","10/12/2019 00:00:00+00","7898.25","1200997.16","[revenue, sales]"
"1","10/12/2019 00:00:00+00","4689.52","1205686.68","[revenue, sales]"
"1","10/12/2019 00:00:00+00","30","1205716.68","[revenue]"
"1","10/12/2019 00:00:00+00","3315.5","1436935.62","[revenue]"
"1","10/12/2019 00:00:00+00","800","1206516.68","[revenue]"
"1","10/12/2019 00:00:00+00","6370","1212886.68","[revenue]"
"1","10/12/2019 00:00:00+00","2748.9","1215635.58","[revenue, sales]"
"1","10/12/2019 00:00:00+00","23004.55","1238640.13","[revenue, sales]"
"1","10/12/2019 00:00:00+00","115.99","1238756.12","[revenue, sales]"
"1","10/12/2019 00:00:00+00","-45.63","1238710.49","[expenditure]"
"1","10/12/2019 00:00:00+00","-4","1238706.49","[expenditure]"
"1","10/12/2019 00:00:00+00","-2397.79","1434537.83","[expenditure, material-supply]"
"1","11/12/2019 00:00:00+00","-1562.5","1432975.33","[expenditure, material-supply]"
"1","11/12/2019 00:00:00+00","-1343.01","1431632.32","[expenditure, material-supply]"
"1","11/12/2019 00:00:00+00","-1380","1430252.32","[expenditure, material-supply]"
"1","11/12/2019 00:00:00+00","-5277.9","1424974.42","[expenditure, material-supply]"
"1","11/12/2019 00:00:00+00","-14464.67","1410509.75","[expenditure, material-supply]"
"1","11/12/2019 00:00:00+00","-1100.5","1409409.25","[expenditure, material-supply]"
"1","11/12/2019 00:00:00+00","-1735.5","1407673.75","[expenditure, material-supply]"
"1","11/12/2019 00:00:00+00","-2002.5","1405671.25","[expenditure, material-supply]"
"1","11/12/2019 00:00:00+00","-9399.5","1396271.75","[expenditure, material-supply]"
"1","11/12/2019 00:00:00+00","-2511.8","1393759.95","[expenditure, material-supply]"
"1","11/12/2019 00:00:00+00","-2182.62","1391577.33","[expenditure, material-supply]"
"1","11/12/2019 00:00:00+00","-5215.02","1386362.31","[expenditure, material-supply]"
"1","11/12/2019 00:00:00+00","-8153","1378209.31","[expenditure, material-supply]"
"1","11/12/2019 00:00:00+00","-1437.45","1376771.86","[expenditure, material-supply]"
"1","11/12/2019 00:00:00+00","-945","1375826.86","[expenditure, material-supply]"
"1","11/12/2019 00:00:00+00","-34270.77","1341556.09","[expenditure, material-supply]"
"1","11/12/2019 00:00:00+00","-0.41","1341555.68","[expenditure, material-supply]"
"1","11/12/2019 00:00:00+00","-0.13","1341555.55","[expenditure, material-supply]"
"1","11/12/2019 00:00:00+00","-32","1238674.49","[expenditure, material-supply]"
"1","11/12/2019 00:00:00+00","-1262","1237412.49","[expenditure, material-supply]"
"1","11/12/2019 00:00:00+00","-1873.5","1235538.99","[expenditure, material-supply]"
"1","11/12/2019 00:00:00+00","-1497.5","1234041.49","[expenditure, material-supply]"
"1","11/12/2019 00:00:00+00","-1417.54","1232623.95","[expenditure, material-supply]"
"1","11/12/2019 00:00:00+00","-5180","1227443.95","[expenditure, material-supply]"
"1","11/12/2019 00:00:00+00","-8586.5","1218857.45","[expenditure, material-supply]"
"1","11/12/2019 00:00:00+00","-2042.8","1216814.65","[expenditure, material-supply]"
"1","11/12/2019 00:00:00+00","-1906.49","1214908.16","[expenditure, material-supply]"
"1","11/12/2019 00:00:00+00","-150","1214758.16","[expenditure, material-supply]"
"1","11/12/2019 00:00:00+00","-1137.5","1213620.66","[expenditure, material-supply]"
"1","11/12/2019 00:00:00+00","-215","1213405.66","[expenditure, material-supply]"
"1","11/12/2019 00:00:00+00","6620","1220025.66","[revenue]"
"1","11/12/2019 00:00:00+00","6530","1226555.66","[revenue, sales]"
"1","11/12/2019 00:00:00+00","100","1226655.66","[revenue]"
"1","11/12/2019 00:00:00+00","4438.18","1231093.84","[revenue, sales]"
"1","11/12/2019 00:00:00+00","1809.56","1343365.11","[revenue, sales]"
"1","11/12/2019 00:00:00+00","2904.82","1346269.93","[revenue, sales]"
"1","11/12/2019 00:00:00+00","10670","1241763.84","[revenue, sales]"
"1","11/12/2019 00:00:00+00","7530","1249293.84","[revenue]"
"1","11/12/2019 00:00:00+00","100","1249393.84","[revenue]"
"1","11/12/2019 00:00:00+00","5130","1254523.84","[revenue]"
"1","11/12/2019 00:00:00+00","3030.5","1257554.34","[revenue]"
"1","11/12/2019 00:00:00+00","910","1258464.34","[revenue, sales]"
"1","11/12/2019 00:00:00+00","100","1258564.34","[revenue, sales]"
"1","11/12/2019 00:00:00+00","-4","1258560.34","[expenditure]"
"1","12/12/2019 00:00:00+00","-214.71","1258345.63","[expenditure, administration, material-supply]"
"1","12/12/2019 00:00:00+00","-691.51","1345578.42","[expenditure, material-supply]"
"1","12/12/2019 00:00:00+00","-498.61","1345079.81","[expenditure, material-supply]"
"1","12/12/2019 00:00:00+00","-555.49","1344524.32","[expenditure, material-supply]"
"1","12/12/2019 00:00:00+00","-110","1344414.32","[expenditure, salary, material-supply]"
"1","12/12/2019 00:00:00+00","-298.12","1344116.2","[expenditure, material-supply]"
"1","12/12/2019 00:00:00+00","-83.84","1344032.36","[expenditure, material-supply]"
"1","12/12/2019 00:00:00+00","-39.41","1343992.95","[expenditure, material-supply]"
"1","12/12/2019 00:00:00+00","-140","1343852.95","[expenditure, material-supply]"
"1","12/12/2019 00:00:00+00","-75.6","1343777.35","[expenditure, material-supply]"
"1","12/12/2019 00:00:00+00","-214.24","1343563.11","[expenditure, material-supply]"
"1","12/12/2019 00:00:00+00","-696.92","1257648.71","[expenditure, material-supply]"
"1","12/12/2019 00:00:00+00","-1855.03","1255793.68","[expenditure, material-supply]"
"1","12/12/2019 00:00:00+00","-15","1255778.68","[expenditure, material-supply]"
"1","12/12/2019 00:00:00+00","-599.76","1255178.92","[expenditure, material-supply]"
"1","12/12/2019 00:00:00+00","-51.28","1255127.64","[expenditure, administration, material-supply]"
"1","12/12/2019 00:00:00+00","-68.21","1255059.43","[expenditure, material-supply]"
"1","12/12/2019 00:00:00+00","-847.28","1254212.15","[expenditure, material-supply]"
"1","12/12/2019 00:00:00+00","-453.99","1253758.16","[expenditure, material-supply]"
"1","12/12/2019 00:00:00+00","-0.21","1253757.95","[expenditure, material-supply]"
"1","12/12/2019 00:00:00+00","-0.35","1253757.6","[expenditure, material-supply]"
"1","12/12/2019 00:00:00+00","-51390.74","1202366.86","[expenditure, material-supply]"
"1","12/12/2019 00:00:00+00","1123.83","1203490.69","[revenue, sales]"
"1","12/12/2019 00:00:00+00","1904.8","1205395.49","[revenue, sales]"
"1","12/12/2019 00:00:00+00","5190.58","1210586.07","[revenue, sales]"
"1","12/12/2019 00:00:00+00","2923.87","1213509.94","[revenue, sales]"
"1","12/12/2019 00:00:00+00","1904.8","1215414.74","[revenue, sales]"
"1","12/12/2019 00:00:00+00","100","1215514.74","[revenue, sales]"
"1","12/12/2019 00:00:00+00","7070","1222584.74","[revenue, sales]"
"1","12/12/2019 00:00:00+00","100","1222684.74","[revenue]"
"1","12/12/2019 00:00:00+00","6859.17","1229543.91","[revenue, sales]"
"1","12/12/2019 00:00:00+00","6285.57","1235829.48","[revenue, sales]"
"1","12/12/2019 00:00:00+00","3489.34","1239318.82","[revenue, sales]"
"1","12/12/2019 00:00:00+00","6960","1246278.82","[revenue]"
"1","12/12/2019 00:00:00+00","100","1246378.82","[revenue, sales]"
"1","12/12/2019 00:00:00+00","6080","1252458.82","[revenue]"
"1","12/12/2019 00:00:00+00","42266.38","1294725.2","[revenue, sales]"
"1","12/12/2019 00:00:00+00","3900","1298625.2","[revenue]"
"1","12/12/2019 00:00:00+00","4914.34","1303539.54","[revenue, sales]"
"1","12/12/2019 00:00:00+00","69.43","1303608.97","[revenue, sales]"
"1","12/12/2019 00:00:00+00","-4","1303604.97","[expenditure]"
"1","13/12/2019 00:00:00+00","2285.76","1305890.73","[revenue, sales]"
"1","13/12/2019 00:00:00+00","6457.27","1312348","[revenue, sales]"
"1","13/12/2019 00:00:00+00","3505.78","1315853.78","[revenue, sales]"
"1","13/12/2019 00:00:00+00","2000.04","1317853.82","[revenue, sales]"
"1","13/12/2019 00:00:00+00","5733.91","1323587.73","[revenue]"
"1","13/12/2019 00:00:00+00","2321.7","1325909.43","[revenue]"
"1","13/12/2019 00:00:00+00","3487.67","1329397.1","[revenue]"
"1","13/12/2019 00:00:00+00","9640.65","1339037.75","[revenue]"
"1","13/12/2019 00:00:00+00","2312.16","1341349.91","[revenue]"
"1","13/12/2019 00:00:00+00","30","1341379.91","[revenue]"
"1","13/12/2019 00:00:00+00","14850","1356229.91","[revenue]"
"1","13/12/2019 00:00:00+00","2110","1358339.91","[revenue]"
"1","13/12/2019 00:00:00+00","3200","1361539.91","[revenue]"
"1","13/12/2019 00:00:00+00","30634.14","1392174.05","[revenue]"
"1","13/12/2019 00:00:00+00","-66.33","1392107.72","[expenditure]"
"1","13/12/2019 00:00:00+00","-4","1392103.72","[expenditure, credit-card]"
"1","13/12/2019 00:00:00+00","-53.55","1392050.17","[expenditure, material-supply]"
"1","13/12/2019 00:00:00+00","-525.23","1391524.94","[expenditure, material-supply]"
"1","13/12/2019 00:00:00+00","-14388.16","1377136.78","[expenditure, material-supply]"
"1","13/12/2019 00:00:00+00","-33573.67","1343563.11","[expenditure, material-supply]"
"1","13/12/2019 00:00:00+00","-1011",,"[expenditure, material-supply]"
"1","13/12/2019 00:00:00+00","-2147.38",,"[expenditure, material-supply]"
"1","13/12/2019 00:00:00+00","-3029.41",,"[expenditure, material-supply]"
"1","13/12/2019 00:00:00+00","-1356.11",,"[expenditure, material-supply]"
"1","13/12/2019 00:00:00+00","-1348",,"[expenditure, material-supply]"
"1","13/12/2019 00:00:00+00","-948.5",,"[expenditure, material-supply]"
"1","13/12/2019 00:00:00+00","-1743.5",,"[expenditure, material-supply]"
"1","13/12/2019 00:00:00+00","-2640",,"[expenditure, material-supply]"
"1","13/12/2019 00:00:00+00","-2820.41",,"[expenditure, material-supply]"
"1","13/12/2019 00:00:00+00","-1402.9",,"[expenditure, material-supply]"
"1","13/12/2019 00:00:00+00","-3581.98",,"[expenditure, material-supply]"
"1","13/12/2019 00:00:00+00","-4160.86",,"[expenditure, material-supply]"
"1","13/12/2019 00:00:00+00","-6263.2",,"[expenditure, material-supply]"
"1","13/12/2019 00:00:00+00","-2399.59",,"[expenditure, material-supply]"
"1","13/12/2019 00:00:00+00","-2198.5",,"[expenditure, material-supply]"
"1","13/12/2019 00:00:00+00","-1889.5",,"[expenditure, material-supply]"
"1","13/12/2019 00:00:00+00","-898",,"[expenditure, material-supply]"
"1","13/12/2019 00:00:00+00","-2871.51",,"[expenditure, material-supply]"
"1","13/12/2019 00:00:00+00","-1226.41",,"[expenditure, material-supply]"
"1","13/12/2019 00:00:00+00","-700",,"[expenditure, material-supply]"
"1","13/12/2019 00:00:00+00","-1335.51",,"[expenditure, material-supply]"
"1","13/12/2019 00:00:00+00","-32792.33",,"[expenditure, material-supply]"
"1","13/12/2019 00:00:00+00","-0.46",,"[expenditure, material-supply]"
"1","13/12/2019 00:00:00+00","-0.2",,"[expenditure, material-supply]"
"1","13/12/2019 00:00:00+00","-4233.5",,"[expenditure, material-supply]"
"1","13/12/2019 00:00:00+00","-7912.68",,"[expenditure, material-supply]"
"1","13/12/2019 00:00:00+00","-1844.5",,"[expenditure, material-supply]"
"1","13/12/2019 00:00:00+00","-327.32",,"[expenditure, material-supply]"
"1","13/12/2019 00:00:00+00","-2544.99",,"[expenditure, material-supply]"
"1","13/12/2019 00:00:00+00","-5290",,"[expenditure, material-supply]"
"1","13/12/2019 00:00:00+00","-6498.6",,"[expenditure, material-supply]"
"1","13/12/2019 00:00:00+00","-14225.97",,"[expenditure, material-supply]"
"1","13/12/2019 00:00:00+00","-1488.4",,"[expenditure, material-supply]"
"1","13/12/2019 00:00:00+00","-4905.4",,"[expenditure, material-supply]"
"1","13/12/2019 00:00:00+00","-2553.5",,"[expenditure, material-supply]"
"1","13/12/2019 00:00:00+00","-1225.7",,"[expenditure, material-supply]"
"1","13/12/2019 00:00:00+00","-1245",,"[expenditure, material-supply]"
"1","13/12/2019 00:00:00+00","2170",,"[revenue, sales]"
"1","13/12/2019 00:00:00+00","2900",,"[revenue, sales]"
"1","13/12/2019 00:00:00+00","115000",,"[revenue, sales]"
"1","16/12/2019 00:00:00+00","-1335.9",,"[expenditure, material-supply]"
"1","16/12/2019 00:00:00+00","-2328.24",,"[expenditure, material-supply]"
"1","16/12/2019 00:00:00+00","-15350.28",,"[expenditure, material-supply]"
"1","16/12/2019 00:00:00+00","-1472.9",,"[expenditure, material-supply]"
"1","16/12/2019 00:00:00+00","-416.6",,"[expenditure, material-supply]"
"1","16/12/2019 00:00:00+00","-2517.58",,"[expenditure, material-supply]"
"1","16/12/2019 00:00:00+00","-945.9",,"[expenditure, material-supply]"
"1","16/12/2019 00:00:00+00","-604",,"[expenditure, material-supply]"
"1","16/12/2019 00:00:00+00","-1354.5",,"[expenditure, material-supply]"
"1","16/12/2019 00:00:00+00","-8995.5",,"[expenditure, material-supply]"
"1","16/12/2019 00:00:00+00","-4194.78",,"[expenditure, material-supply]"
"1","16/12/2019 00:00:00+00","-2018.35",,"[expenditure, material-supply]"
"1","16/12/2019 00:00:00+00","-3387.4",,"[expenditure, material-supply]"
"1","16/12/2019 00:00:00+00","-2571.46",,"[expenditure, material-supply]"
"1","16/12/2019 00:00:00+00","-78.54",,"[expenditure]"
"1","16/12/2019 00:00:00+00","-0.38",,"[expenditure, material-supply]"
"1","16/12/2019 00:00:00+00","-0.23",,"[expenditure, material-supply]"
"1","16/12/2019 00:00:00+00","-0.34",,"[expenditure, material-supply]"
"1","16/12/2019 00:00:00+00","-0.26",,"[expenditure, material-supply]"
"1","16/12/2019 00:00:00+00","-129000",,"[expenditure, material-supply]"
"1","16/12/2019 00:00:00+00","119786",,"[revenue, sales]"
"1","16/12/2019 00:00:00+00","9780",,"[revenue, sales]"
"1","16/12/2019 00:00:00+00","1270",,"[revenue]"
"1","16/12/2019 00:00:00+00","8370",,"[revenue]"
"1","16/12/2019 00:00:00+00","1390.5",,"[revenue, sales]"
"1","16/12/2019 00:00:00+00","2657.2",,"[revenue, sales]"
"1","16/12/2019 00:00:00+00","4390.56",,"[revenue, sales]"
"1","16/12/2019 00:00:00+00","21580",,"[revenue]"
"1","16/12/2019 00:00:00+00","10200",,"[revenue, sales]"
"1","16/12/2019 00:00:00+00","5825.26",,"[revenue, sales]"
"1","16/12/2019 00:00:00+00","10230",,"[revenue, sales]"
"1","16/12/2019 00:00:00+00","7600",,"[revenue]"
"1","16/12/2019 00:00:00+00","3640",,"[revenue, sales]"
"1","16/12/2019 00:00:00+00","9650",,"[revenue]"
"1","16/12/2019 00:00:00+00","5490",,"[revenue]"
"1","16/12/2019 00:00:00+00","8061.84",,"[revenue, sales]"
"1","16/12/2019 00:00:00+00","-4",,"[expenditure, credit-card]"
"1","16/12/2019 00:00:00+00","-1099.44",,"[expenditure, administration, material-supply]"
"1","16/12/2019 00:00:00+00","-24072.41",,"[expenditure, credit-card, credit, material-supply]"
"1","16/12/2019 00:00:00+00","40000",,"[revenue, deposit]"
"1","17/12/2019 00:00:00+00","-3631",,"[expenditure, material-supply]"
"1","17/12/2019 00:00:00+00","-1105.41",,"[expenditure, material-supply]"
"1","17/12/2019 00:00:00+00","-4355.2",,"[expenditure, material-supply]"
"1","17/12/2019 00:00:00+00","-881",,"[expenditure, material-supply]"
"1","17/12/2019 00:00:00+00","-1796",,"[expenditure, material-supply]"
"1","17/12/2019 00:00:00+00","-7176.41",,"[expenditure, material-supply]"
"1","17/12/2019 00:00:00+00","-2294.99",,"[expenditure, material-supply]"
"1","17/12/2019 00:00:00+00","-331",,"[expenditure, material-supply]"
"1","17/12/2019 00:00:00+00","-2551.5",,"[expenditure, material-supply]"
"1","17/12/2019 00:00:00+00","-3355.49",,"[expenditure, material-supply]"
"1","17/12/2019 00:00:00+00","-1944",,"[expenditure, material-supply]"
"1","17/12/2019 00:00:00+00","-1697.9",,"[expenditure, material-supply]"
"1","17/12/2019 00:00:00+00","-202.5",,"[expenditure, material-supply]"
"1","17/12/2019 00:00:00+00","-700",,"[expenditure, material-supply]"
"1","17/12/2019 00:00:00+00","-4154.17",,"[expenditure, law, tax, material-supply]"
"1","17/12/2019 00:00:00+00","-3367.7",,"[expenditure, law, tax, material-supply]"
"1","17/12/2019 00:00:00+00","-75.6",,"[expenditure, material-supply]"
"1","17/12/2019 00:00:00+00","-836.69",,"[expenditure, material-supply]"
"1","17/12/2019 00:00:00+00","-456.37",,"[expenditure, material-supply]"
"1","17/12/2019 00:00:00+00","-143.87",,"[expenditure, material-supply]"
"1","17/12/2019 00:00:00+00","-886.28",,"[expenditure, material-supply]"
"1","17/12/2019 00:00:00+00","-202.3",,"[expenditure, material-supply]"
"1","17/12/2019 00:00:00+00","-54.81",,"[expenditure, material-supply]"
"1","17/12/2019 00:00:00+00","-143.72",,"[expenditure, material-supply]"
"1","17/12/2019 00:00:00+00","-36.87",,"[expenditure, material-supply]"
"1","17/12/2019 00:00:00+00","-95.83",,"[expenditure, material-supply]"
"1","17/12/2019 00:00:00+00","-6069",,"[expenditure, material-supply]"
"1","17/12/2019 00:00:00+00","-2901.61",,"[expenditure, material-supply]"
"1","17/12/2019 00:00:00+00","-244.18",,"[expenditure, material-supply]"
"1","17/12/2019 00:00:00+00","-165.41",,"[expenditure, material-supply]"
"1","17/12/2019 00:00:00+00","-59573.89",,"[expenditure, material-supply]"
"1","17/12/2019 00:00:00+00","-4902.8",,"[expenditure]"
"1","17/12/2019 00:00:00+00","-3750",,"[expenditure, material-supply]"
"1","17/12/2019 00:00:00+00","-0.03",,"[expenditure, material-supply]"
"1","17/12/2019 00:00:00+00","-26.36",,"[expenditure]"
"1","17/12/2019 00:00:00+00","-3214.28",,"[expenditure]"
"1","17/12/2019 00:00:00+00","-17.4",,"[expenditure]"
"1","17/12/2019 00:00:00+00","2030",,"[revenue]"
"1","17/12/2019 00:00:00+00","3030",,"[revenue]"
"1","17/12/2019 00:00:00+00","60000",,"[revenue, sales]"
"1","17/12/2019 00:00:00+00","4730",,"[revenue, sales]"
"1","17/12/2019 00:00:00+00","1960",,"[revenue]"
"1","17/12/2019 00:00:00+00","1514.32",,"[revenue, sales]"
"1","17/12/2019 00:00:00+00","866.68",,"[revenue, sales]"
"1","17/12/2019 00:00:00+00","1676.22",,"[revenue, sales]"
"1","17/12/2019 00:00:00+00","8733.51",,"[revenue, sales]"
"1","17/12/2019 00:00:00+00","9038.28",,"[revenue, sales]"
"1","17/12/2019 00:00:00+00","2331.59",,"[revenue, sales]"
"1","17/12/2019 00:00:00+00","9044.62",,"[revenue, sales]"
"1","17/12/2019 00:00:00+00","6046",,"[revenue, sales]"
"1","17/12/2019 00:00:00+00","10058.81",,"[revenue, sales]"
"1","17/12/2019 00:00:00+00","1390",,"[revenue]"
"1","17/12/2019 00:00:00+00","3640",,"[revenue, sales]"
"1","17/12/2019 00:00:00+00","3990",,"[revenue, sales]"
"1","17/12/2019 00:00:00+00","33127.66",,"[revenue, sales]"
"1","17/12/2019 00:00:00+00","26.36",,"[revenue, sales]"
"1","17/12/2019 00:00:00+00","17.4",,"[revenue, sales]"
"1","17/12/2019 00:00:00+00","-4",,"[expenditure]"
"1","17/12/2019 00:00:00+00","-4",,"[expenditure, credit-card]"
"1","17/12/2019 00:00:00+00","-4",,"[expenditure]"
"1","17/12/2019 00:00:00+00","-4",,"[expenditure]"
"1","18/12/2019 00:00:00+00","-716",,"[expenditure, material-supply]"
"1","18/12/2019 00:00:00+00","-2617.79",,"[expenditure, material-supply]"
"1","18/12/2019 00:00:00+00","-3822.7",,"[expenditure, material-supply]"
"1","18/12/2019 00:00:00+00","-1073.6",,"[expenditure, material-supply]"
"1","18/12/2019 00:00:00+00","-4524",,"[expenditure, material-supply]"
"1","18/12/2019 00:00:00+00","-5454.22",,"[expenditure, material-supply]"
"1","18/12/2019 00:00:00+00","-2801.8",,"[expenditure, material-supply]"
"1","18/12/2019 00:00:00+00","-1464.5",,"[expenditure, material-supply]"
"1","18/12/2019 00:00:00+00","-6553.37",,"[expenditure, material-supply]"
"1","18/12/2019 00:00:00+00","-3102.4",,"[expenditure, material-supply]"
"1","18/12/2019 00:00:00+00","-4178",,"[expenditure, material-supply]"
"1","18/12/2019 00:00:00+00","-14553.37",,"[expenditure, material-supply]"
"1","18/12/2019 00:00:00+00","-5479",,"[expenditure, material-supply]"
"1","18/12/2019 00:00:00+00","-10635.02",,"[expenditure, material-supply]"
"1","18/12/2019 00:00:00+00","-575",,"[expenditure, material-supply]"
"1","18/12/2019 00:00:00+00","-2234.01",,"[expenditure, material-supply]"
"1","18/12/2019 00:00:00+00","-7235.53",,"[expenditure, material-supply]"
"1","18/12/2019 00:00:00+00","-3696.98",,"[expenditure, material-supply]"
"1","18/12/2019 00:00:00+00","-300",,"[expenditure, material-supply]"
"1","18/12/2019 00:00:00+00","-15829.98",,"[expenditure, material-supply]"
"1","18/12/2019 00:00:00+00","6680",,"[revenue, sales]"
"1","18/12/2019 00:00:00+00","10000",,"[revenue, sales]"
"1","18/12/2019 00:00:00+00","1342.88",,"[revenue, sales]"
"1","18/12/2019 00:00:00+00","2847.68",,"[revenue, sales]"
"1","18/12/2019 00:00:00+00","1476.22",,"[revenue, sales]"
"1","18/12/2019 00:00:00+00","2638.15",,"[revenue, sales]"
"1","18/12/2019 00:00:00+00","1571.46",,"[revenue, sales]"
"1","18/12/2019 00:00:00+00","100",,"[revenue, sales]"
"1","18/12/2019 00:00:00+00","5710",,"[revenue]"
"1","18/12/2019 00:00:00+00","2665.47",,"[revenue, sales]"
"1","18/12/2019 00:00:00+00","3470",,"[revenue, sales]"
"1","18/12/2019 00:00:00+00","3390",,"[revenue, sales]"
"1","18/12/2019 00:00:00+00","9382.44",,"[revenue, sales]"
"1","18/12/2019 00:00:00+00","7121.49",,"[revenue, sales]"
"1","18/12/2019 00:00:00+00","3062.86",,"[revenue, sales]"
"1","18/12/2019 00:00:00+00","17290",,"[revenue, sales]"
"1","18/12/2019 00:00:00+00","4235.72",,"[revenue, sales]"
"1","18/12/2019 00:00:00+00","232.88",,"[revenue, sales]"
"1","18/12/2019 00:00:00+00","39830.28",,"[revenue]"
"1","18/12/2019 00:00:00+00","-4",,"[expenditure, credit-card]"
"1","19/12/2019 00:00:00+00","-1.86",,"[expenditure]"
"1","19/12/2019 00:00:00+00","-3",,"[expenditure]"
"1","19/12/2019 00:00:00+00","-3",,"[expenditure]"
"1","19/12/2019 00:00:00+00","-208.83",,"[expenditure]"
"1","19/12/2019 00:00:00+00","-0.26",,"[expenditure, material-supply]"
"1","19/12/2019 00:00:00+00","-0.46",,"[expenditure, material-supply]"
"1","19/12/2019 00:00:00+00","-0.49",,"[expenditure, material-supply]"
"1","19/12/2019 00:00:00+00","-0.49",,"[expenditure, material-supply]"
"1","19/12/2019 00:00:00+00","-51529.86",,"[expenditure, material-supply]"
"1","19/12/2019 00:00:00+00","1104.78",,"[revenue, sales]"
"1","19/12/2019 00:00:00+00","1800.04",,"[revenue, sales]"
"1","19/12/2019 00:00:00+00","8628.74",,"[revenue, sales]"
"1","19/12/2019 00:00:00+00","5085.82",,"[revenue, sales]"
"1","19/12/2019 00:00:00+00","1847.66",,"[revenue, sales]"
"1","19/12/2019 00:00:00+00","2733.39",,"[revenue, sales]"
"1","19/12/2019 00:00:00+00","1242.88",,"[revenue, sales]"
"1","19/12/2019 00:00:00+00","3509.59",,"[revenue, sales]"
"1","19/12/2019 00:00:00+00","2057.18",,"[revenue, sales]"
"1","19/12/2019 00:00:00+00","4752.48",,"[revenue, sales]"
"1","19/12/2019 00:00:00+00","3874.42",,"[revenue, sales]"
"1","19/12/2019 00:00:00+00","3906.12",,"[revenue, sales]"
"1","19/12/2019 00:00:00+00","2059.57",,"[revenue, sales]"
"1","19/12/2019 00:00:00+00","19109.31",,"[revenue, sales]"
"1","19/12/2019 00:00:00+00","3",,"[revenue, sales]"
"1","19/12/2019 00:00:00+00","3",,"[revenue, sales]"
"1","19/12/2019 00:00:00+00","-4",,"[expenditure]"
"1","19/12/2019 00:00:00+00","-34.99",,"[expenditure, material-supply]"
"1","19/12/2019 00:00:00+00","-4.79",,"[expenditure, material-supply]"
"1","20/12/2019 00:00:00+00","-158.87",,"[expenditure, material-supply]"
"1","20/12/2019 00:00:00+00","-172.15",,"[expenditure, material-supply]"
"1","20/12/2019 00:00:00+00","-68.75",,"[expenditure, material-supply]"
"1","20/12/2019 00:00:00+00","-277.88",,"[expenditure, material-supply]"
"1","20/12/2019 00:00:00+00","-463.62",,"[expenditure, material-supply]"
"1","20/12/2019 00:00:00+00","-158.27",,"[expenditure, material-supply]"
"1","20/12/2019 00:00:00+00","-396.1",,"[expenditure, material-supply]"
"1","20/12/2019 00:00:00+00","-169.11",,"[expenditure, material-supply]"
"1","20/12/2019 00:00:00+00","-170.86",,"[expenditure, material-supply]"
"1","20/12/2019 00:00:00+00","-146.4",,"[expenditure, material-supply]"
"1","20/12/2019 00:00:00+00","-658.86",,"[insurance, expenditure, material-supply]"
"1","20/12/2019 00:00:00+00","-37.64",,"[expenditure, material-supply]"
"1","20/12/2019 00:00:00+00","-749.7",,"[expenditure, material-supply]"
"1","20/12/2019 00:00:00+00","-859.78",,"[expenditure, material-supply]"
"1","20/12/2019 00:00:00+00","-17.64",,"[expenditure, material-supply]"
"1","20/12/2019 00:00:00+00","-3",,"[expenditure]"
"1","20/12/2019 00:00:00+00","-0.19",,"[expenditure, material-supply]"
"1","20/12/2019 00:00:00+00","-0.31",,"[expenditure, material-supply]"
"1","20/12/2019 00:00:00+00","-90129.02",,"[expenditure]"
"1","20/12/2019 00:00:00+00","-168171.92",,"[expenditure]"
"1","20/12/2019 00:00:00+00","-27745.29",,"[expenditure, material-supply]"
"1","20/12/2019 00:00:00+00","-615.8",,"[expenditure, material-supply]"
"1","20/12/2019 00:00:00+00","-624.5",,"[expenditure, material-supply]"
"1","20/12/2019 00:00:00+00","-1190.04",,"[expenditure, material-supply]"
"1","20/12/2019 00:00:00+00","-2992.28",,"[expenditure, material-supply]"
"1","20/12/2019 00:00:00+00","-2043",,"[expenditure, material-supply]"
"1","20/12/2019 00:00:00+00","-558",,"[expenditure, material-supply]"
"1","20/12/2019 00:00:00+00","-3423",,"[expenditure, material-supply]"
"1","20/12/2019 00:00:00+00","-45",,"[expenditure, material-supply]"
"1","20/12/2019 00:00:00+00","-1196.71",,"[expenditure, material-supply]"
"1","20/12/2019 00:00:00+00","-3193.72",,"[expenditure, material-supply]"
"1","20/12/2019 00:00:00+00","-3301",,"[expenditure, material-supply]"
"1","20/12/2019 00:00:00+00","-4346.26",,"[expenditure, material-supply]"
"1","20/12/2019 00:00:00+00","-1677.09",,"[expenditure, material-supply]"
"1","20/12/2019 00:00:00+00","-46539.86",,"[expenditure, tax, salary-extra-costs, salary, material-supply]"
"1","20/12/2019 00:00:00+00","222",,"[revenue]"
"1","20/12/2019 00:00:00+00","10550",,"[revenue]"
"1","20/12/2019 00:00:00+00","3430",,"[revenue, sales]"
"1","20/12/2019 00:00:00+00","294.95",,"[revenue]"
"1","20/12/2019 00:00:00+00","30",,"[revenue]"
"1","20/12/2019 00:00:00+00","2981.01",,"[revenue, sales]"
"1","20/12/2019 00:00:00+00","1790.51",,"[revenue, sales]"
"1","20/12/2019 00:00:00+00","2238.14",,"[revenue, sales]"
"1","20/12/2019 00:00:00+00","4571.52",,"[revenue, sales]"
"1","20/12/2019 00:00:00+00","2759.05",,"[revenue, sales]"
"1","20/12/2019 00:00:00+00","2428.74",,"[revenue, sales]"
"1","20/12/2019 00:00:00+00","43",,"[revenue]"
"1","20/12/2019 00:00:00+00","700",,"[revenue]"
"1","20/12/2019 00:00:00+00","4370",,"[revenue]"
"1","20/12/2019 00:00:00+00","64264.22",,"[revenue, sales]"
"1","20/12/2019 00:00:00+00","1150",,"[revenue, sales]"
"1","20/12/2019 00:00:00+00","3",,"[revenue, sales]"
"1","20/12/2019 00:00:00+00","-15583.01",,"[expenditure, material-supply]"
"1","20/12/2019 00:00:00+00","-34.71",,"[expenditure]"
"1","20/12/2019 00:00:00+00","-4",,"[expenditure]"
"1","20/12/2019 00:00:00+00","-4",,"[expenditure]"
"1","20/12/2019 00:00:00+00","-586.43",,"[expenditure, material-supply]"
"1","20/12/2019 00:00:00+00","-3",,"[expenditure]"
"1","20/12/2019 00:00:00+00","-95.2",,"[expenditure, credit, material-supply]"
"1","20/12/2019 00:00:00+00","-15.58",,"[expenditure, material-supply]"
"1","20/12/2019 00:00:00+00","-3",,"[expenditure]"
"1","23/12/2019 00:00:00+00","-1418.4",,"[expenditure, material-supply]"
"1","23/12/2019 00:00:00+00","-3096",,"[expenditure, material-supply]"
"1","23/12/2019 00:00:00+00","-522.23",,"[expenditure, material-supply]"
"1","23/12/2019 00:00:00+00","-8105.99",,"[expenditure, material-supply]"
"1","23/12/2019 00:00:00+00","-30",,"[expenditure, material-supply]"
"1","23/12/2019 00:00:00+00","-1891.78",,"[expenditure, material-supply]"
"1","23/12/2019 00:00:00+00","-1121.3",,"[expenditure, material-supply]"
"1","23/12/2019 00:00:00+00","-1671",,"[expenditure, material-supply]"
"1","23/12/2019 00:00:00+00","-1176.6",,"[expenditure, material-supply]"
"1","23/12/2019 00:00:00+00","-1182.29",,"[expenditure, material-supply]"
"1","23/12/2019 00:00:00+00","-9006.78",,"[expenditure, material-supply]"
"1","23/12/2019 00:00:00+00","-1485.7",,"[expenditure, material-supply]"
"1","23/12/2019 00:00:00+00","-30",,"[expenditure, material-supply]"
"1","23/12/2019 00:00:00+00","-719.92",,"[expenditure, material-supply]"
"1","23/12/2019 00:00:00+00","-97",,"[expenditure, material-supply]"
"1","23/12/2019 00:00:00+00","-778.47",,"[expenditure, material-supply]"
"1","23/12/2019 00:00:00+00","-12485.23",,"[expenditure, material-supply]"
"1","23/12/2019 00:00:00+00","-3086.37",,"[expenditure, material-supply]"
"1","23/12/2019 00:00:00+00","-1577.19",,"[expenditure, material-supply]"
"1","23/12/2019 00:00:00+00","-2132.9",,"[expenditure, material-supply]"
"1","23/12/2019 00:00:00+00","-686.8",,"[expenditure, material-supply]"
"1","23/12/2019 00:00:00+00","-95",,"[expenditure, material-supply]"
"1","23/12/2019 00:00:00+00","-0.13",,"[expenditure, material-supply]"
"1","23/12/2019 00:00:00+00","-676.88",,"[expenditure]"
"1","23/12/2019 00:00:00+00","-2",,"[expenditure, material-supply]"
"1","23/12/2019 00:00:00+00","-23700.32",,"[expenditure, material-supply]"
"1","23/12/2019 00:00:00+00","-4325.7",,"[expenditure, material-supply]"
"1","23/12/2019 00:00:00+00","-3180.99",,"[expenditure, material-supply]"
"1","23/12/2019 00:00:00+00","-4163.98",,"[expenditure, material-supply]"
"1","23/12/2019 00:00:00+00","-6607.52",,"[expenditure, material-supply]"
"1","23/12/2019 00:00:00+00","-1639",,"[expenditure, material-supply]"
"1","23/12/2019 00:00:00+00","-635",,"[expenditure, material-supply]"
"1","23/12/2019 00:00:00+00","-470.6",,"[expenditure, material-supply]"
"1","23/12/2019 00:00:00+00","-2792.5",,"[expenditure, material-supply]"
"1","23/12/2019 00:00:00+00","-100",,"[expenditure, material-supply]"
"1","23/12/2019 00:00:00+00","-3640",,"[expenditure, material-supply]"
"1","23/12/2019 00:00:00+00","-11585.15",,"[expenditure, material-supply]"
"1","23/12/2019 00:00:00+00","-120",,"[expenditure, material-supply]"
"1","23/12/2019 00:00:00+00","-873.5",,"[expenditure, material-supply]"
"1","23/12/2019 00:00:00+00","-4398.41",,"[expenditure, material-supply]"
"1","23/12/2019 00:00:00+00","-4642.76",,"[expenditure, material-supply]"
"1","23/12/2019 00:00:00+00","7230",,"[revenue, sales]"
"1","23/12/2019 00:00:00+00","122.11",,"[revenue, sales]"
"1","23/12/2019 00:00:00+00","135",,"[revenue, sales]"
"1","23/12/2019 00:00:00+00","9954.16",,"[revenue, sales]"
"1","23/12/2019 00:00:00+00","30000",,"[revenue, sales]"
"1","23/12/2019 00:00:00+00","1009.54",,"[revenue, sales]"
"1","23/12/2019 00:00:00+00","4361.99",,"[revenue, sales]"
"1","23/12/2019 00:00:00+00","971.45",,"[revenue, sales]"
"1","23/12/2019 00:00:00+00","5771.54",,"[revenue, sales]"
"1","23/12/2019 00:00:00+00","280",,"[revenue, sales]"
"1","23/12/2019 00:00:00+00","2830",,"[revenue]"
"1","23/12/2019 00:00:00+00","22766.25",,"[revenue, sales]"
"1","23/12/2019 00:00:00+00","338",,"[revenue]"
"1","23/12/2019 00:00:00+00","29961.02",,"[revenue]"
"1","23/12/2019 00:00:00+00","-8321.57",,"[expenditure, material-supply]"
"1","23/12/2019 00:00:00+00","-325.24",,"[expenditure, material-supply]"
"1","23/12/2019 00:00:00+00","-275.34",,"[expenditure, material-supply]"
"1","23/12/2019 00:00:00+00","-47.6",,"[expenditure, material-supply, cash]"
"1","23/12/2019 00:00:00+00","399250.36",,"[revenue]"
"1","23/12/2019 00:00:00+00","4734",,"[revenue]"
"1","23/12/2019 00:00:00+00","-320",,"[expenditure, credit, material-supply]"
"1","23/12/2019 00:00:00+00","-10",,"[expenditure, credit, material-supply]"
"1","23/12/2019 00:00:00+00","-10",,"[expenditure, credit, material-supply]"
"1","23/12/2019 00:00:00+00","-10",,"[expenditure, administration, credit, material-supply]"
"1","23/12/2019 00:00:00+00","-10",,"[expenditure, administration, credit, material-supply]"
"1","23/12/2019 00:00:00+00","-75",,"[expenditure, credit, material-supply]"
"1","23/12/2019 00:00:00+00","-87.5",,"[expenditure, credit, material-supply]"
"1","23/12/2019 00:00:00+00","-40",,"[expenditure, credit, material-supply]"
"1","23/12/2019 00:00:00+00","-120",,"[expenditure, credit, material-supply]"
"1","23/12/2019 00:00:00+00","-4",,"[expenditure, material-supply]"
"1","23/12/2019 00:00:00+00","-4",,"[expenditure]"
"1","23/12/2019 00:00:00+00","-29.96",,"[expenditure]"
"1","23/12/2019 00:00:00+00","-5",,"[expenditure]"
"1","23/12/2019 00:00:00+00","-121",,"[expenditure]"
"1","24/12/2019 00:00:00+00","-3406",,"[expenditure, material-supply]"
"1","24/12/2019 00:00:00+00","-2865.2",,"[expenditure, material-supply]"
"1","24/12/2019 00:00:00+00","-4198.02",,"[expenditure, material-supply]"
"1","24/12/2019 00:00:00+00","-3696.5",,"[expenditure, material-supply]"
"1","24/12/2019 00:00:00+00","-709.69",,"[expenditure, material-supply]"
"1","24/12/2019 00:00:00+00","-5413",,"[expenditure, material-supply]"
"1","24/12/2019 00:00:00+00","-2888.19",,"[expenditure, material-supply]"
"1","24/12/2019 00:00:00+00","-2805.16",,"[expenditure, material-supply]"
"1","24/12/2019 00:00:00+00","-1787",,"[expenditure, material-supply]"
"1","24/12/2019 00:00:00+00","-9040",,"[expenditure, material-supply]"
"1","24/12/2019 00:00:00+00","-1923.77",,"[expenditure, material-supply]"
"1","24/12/2019 00:00:00+00","-1598.49",,"[expenditure, material-supply]"
"1","24/12/2019 00:00:00+00","-1722.31",,"[expenditure, material-supply]"
"1","24/12/2019 00:00:00+00","-1011.9",,"[expenditure, material-supply]"
"1","24/12/2019 00:00:00+00","-1748.49",,"[expenditure, material-supply]"
"1","24/12/2019 00:00:00+00","-6704",,"[expenditure, material-supply]"
"1","24/12/2019 00:00:00+00","-589.2",,"[expenditure, material-supply]"
"1","24/12/2019 00:00:00+00","-5160.7",,"[expenditure, material-supply]"
"1","24/12/2019 00:00:00+00","-2778.98",,"[expenditure, material-supply]"
"1","24/12/2019 00:00:00+00","-1263.51",,"[expenditure, material-supply]"
"1","24/12/2019 00:00:00+00","-578.1",,"[expenditure]"
"1","24/12/2019 00:00:00+00","-0.39",,"[expenditure, material-supply]"
"1","24/12/2019 00:00:00+00","-0.41",,"[expenditure, material-supply]"
"1","24/12/2019 00:00:00+00","-0.09",,"[expenditure, material-supply]"
"1","24/12/2019 00:00:00+00","-173.74",,"[expenditure, material-supply]"
"1","24/12/2019 00:00:00+00","-849.95",,"[expenditure, material-supply]"
"1","24/12/2019 00:00:00+00","-417.1",,"[expenditure, material-supply]"
"1","24/12/2019 00:00:00+00","-275.01",,"[expenditure, material-supply]"
"1","24/12/2019 00:00:00+00","-101.38",,"[expenditure, material-supply]"
"1","24/12/2019 00:00:00+00","-957.8",,"[expenditure, material-supply]"
"1","24/12/2019 00:00:00+00","-4112.59",,"[expenditure, material-supply]"
"1","24/12/2019 00:00:00+00","-915.06",,"[expenditure, material-supply]"
"1","24/12/2019 00:00:00+00","-294.1",,"[expenditure, material-supply]"
"1","24/12/2019 00:00:00+00","10350",,"[revenue]"
"1","24/12/2019 00:00:00+00","9840",,"[revenue]"
"1","24/12/2019 00:00:00+00","10150",,"[revenue]"
"1","24/12/2019 00:00:00+00","1161.93",,"[revenue, sales]"
"1","24/12/2019 00:00:00+00","1552.41",,"[revenue, sales]"
"1","24/12/2019 00:00:00+00","9095.42",,"[revenue, sales]"
"1","24/12/2019 00:00:00+00","3909.6",,"[revenue, sales]"
"1","24/12/2019 00:00:00+00","1100",,"[revenue]"
"1","24/12/2019 00:00:00+00","8260",,"[revenue]"
"1","24/12/2019 00:00:00+00","7370",,"[revenue]"
"1","24/12/2019 00:00:00+00","5930",,"[revenue]"
"1","24/12/2019 00:00:00+00","15409.22",,"[revenue, sales]"
"1","24/12/2019 00:00:00+00","11282.77",,"[revenue, sales]"
"1","24/12/2019 00:00:00+00","-24.62",,"[expenditure]"
"1","24/12/2019 00:00:00+00","-3",,"[expenditure]"
"1","24/12/2019 00:00:00+00","-3",,"[expenditure]"
"1","27/12/2019 00:00:00+00","-3218.13",,"[expenditure, material-supply]"
"1","27/12/2019 00:00:00+00","-929.95",,"[expenditure, material-supply]"
"1","27/12/2019 00:00:00+00","-2187.61",,"[expenditure, material-supply]"
"1","27/12/2019 00:00:00+00","-6609.07",,"[expenditure, material-supply]"
"1","27/12/2019 00:00:00+00","-4498.37",,"[expenditure, material-supply]"
"1","27/12/2019 00:00:00+00","-955.03",,"[expenditure, material-supply]"
"1","27/12/2019 00:00:00+00","-467.94",,"[expenditure, material-supply]"
"1","27/12/2019 00:00:00+00","-1054.03",,"[expenditure, material-supply]"
"1","27/12/2019 00:00:00+00","-2107.4",,"[expenditure, material-supply]"
"1","27/12/2019 00:00:00+00","-8950.12",,"[expenditure, material-supply]"
"1","27/12/2019 00:00:00+00","-6556.32",,"[expenditure, material-supply]"
"1","27/12/2019 00:00:00+00","-1801",,"[expenditure, material-supply]"
"1","27/12/2019 00:00:00+00","-16290.5",,"[expenditure, material-supply]"
"1","27/12/2019 00:00:00+00","-1127.5",,"[expenditure, material-supply]"
"1","27/12/2019 00:00:00+00","-1915",,"[expenditure, material-supply]"
"1","27/12/2019 00:00:00+00","-1963",,"[expenditure, material-supply]"
"1","27/12/2019 00:00:00+00","-642.99",,"[expenditure, material-supply]"
"1","27/12/2019 00:00:00+00","-990",,"[expenditure, material-supply]"
"1","27/12/2019 00:00:00+00","-572.32",,"[expenditure, material-supply]"
"1","27/12/2019 00:00:00+00","-9126.91",,"[expenditure, material-supply]"
"1","27/12/2019 00:00:00+00","-2952.44",,"[expenditure, material-supply]"
"1","27/12/2019 00:00:00+00","-1447.52",,"[expenditure, material-supply]"
"1","27/12/2019 00:00:00+00","-2282.5",,"[expenditure, material-supply]"
"1","27/12/2019 00:00:00+00","-3842",,"[expenditure, material-supply]"
"1","27/12/2019 00:00:00+00","-2236.61",,"[expenditure, material-supply]"
"1","27/12/2019 00:00:00+00","-8171",,"[expenditure, material-supply]"
"1","27/12/2019 00:00:00+00","-3067",,"[expenditure, material-supply]"
"1","27/12/2019 00:00:00+00","-1712.4",,"[expenditure, material-supply]"
"1","27/12/2019 00:00:00+00","-3326",,"[expenditure, material-supply]"
"1","27/12/2019 00:00:00+00","-2933.8",,"[expenditure, material-supply]"
"1","27/12/2019 00:00:00+00","-2418.64",,"[expenditure, material-supply]"
"1","27/12/2019 00:00:00+00","-1404.83",,"[expenditure, material-supply]"
"1","27/12/2019 00:00:00+00","-9853.66",,"[expenditure, material-supply]"
"1","27/12/2019 00:00:00+00","-2074.87",,"[expenditure, material-supply]"
"1","27/12/2019 00:00:00+00","-8128",,"[expenditure, material-supply]"
"1","27/12/2019 00:00:00+00","-1413",,"[expenditure, material-supply]"
"1","27/12/2019 00:00:00+00","-1287.1",,"[expenditure, material-supply]"
"1","27/12/2019 00:00:00+00","-464",,"[expenditure, material-supply]"
"1","27/12/2019 00:00:00+00","-1436.9",,"[expenditure, material-supply]"
"1","27/12/2019 00:00:00+00","-5482.12",,"[expenditure, material-supply]"
"1","27/12/2019 00:00:00+00","-1611",,"[expenditure, material-supply]"
"1","27/12/2019 00:00:00+00","-1800.2",,"[expenditure, material-supply]"
"1","27/12/2019 00:00:00+00","-2384",,"[expenditure, material-supply]"
"1","27/12/2019 00:00:00+00","-716.25",,"[expenditure, material-supply]"
"1","27/12/2019 00:00:00+00","-640.7",,"[expenditure, material-supply]"
"1","27/12/2019 00:00:00+00","-2304",,"[expenditure, material-supply]"
"1","27/12/2019 00:00:00+00","-3089.93",,"[expenditure, material-supply]"
"1","27/12/2019 00:00:00+00","-319813.86",,"[expenditure]"
"1","27/12/2019 00:00:00+00","5000",,"[revenue]"
"1","27/12/2019 00:00:00+00","5000",,"[revenue]"
"1","27/12/2019 00:00:00+00","6270",,"[revenue, sales]"
"1","27/12/2019 00:00:00+00","2285.76",,"[revenue, sales]"
"1","27/12/2019 00:00:00+00","10476.4",,"[revenue, sales]"
"1","27/12/2019 00:00:00+00","100",,"[revenue]"
"1","27/12/2019 00:00:00+00","450",,"[revenue]"
"1","27/12/2019 00:00:00+00","2870",,"[revenue, sales]"
"1","27/12/2019 00:00:00+00","40671.31",,"[revenue, sales]"
"1","27/12/2019 00:00:00+00","-18.46",,"[expenditure]"
"1","27/12/2019 00:00:00+00","-122.43",,"[expenditure, material-supply]"
"1","27/12/2019 00:00:00+00","-518.4",,"[expenditure, material-supply]"
"1","27/12/2019 00:00:00+00","-2000",,"[expenditure]"
"1","27/12/2019 00:00:00+00","-1000",,"[expenditure]"
"1","30/12/2019 00:00:00+00","-1500.9",,"[expenditure, material-supply]"
"1","30/12/2019 00:00:00+00","-1234",,"[expenditure, material-supply]"
"1","30/12/2019 00:00:00+00","-1620.14",,"[expenditure, material-supply]"
"1","30/12/2019 00:00:00+00","-1279.18",,"[expenditure, material-supply]"
"1","30/12/2019 00:00:00+00","-5297.91",,"[expenditure, material-supply]"
"1","30/12/2019 00:00:00+00","-2721.5",,"[expenditure, material-supply]"
"1","30/12/2019 00:00:00+00","-2065",,"[expenditure, material-supply]"
"1","30/12/2019 00:00:00+00","-3485",,"[expenditure, material-supply]"
"1","30/12/2019 00:00:00+00","-3233.91",,"[expenditure, material-supply]"
"1","30/12/2019 00:00:00+00","-1002.5",,"[expenditure, material-supply]"
"1","30/12/2019 00:00:00+00","-1987",,"[expenditure, material-supply]"
"1","30/12/2019 00:00:00+00","-997.5",,"[expenditure, material-supply]"
"1","30/12/2019 00:00:00+00","-798.83",,"[expenditure, material-supply]"
"1","30/12/2019 00:00:00+00","-7328.02",,"[expenditure, material-supply]"
"1","30/12/2019 00:00:00+00","-1705.78",,"[expenditure, material-supply]"
"1","30/12/2019 00:00:00+00","-3810.89",,"[expenditure, material-supply]"
"1","30/12/2019 00:00:00+00","-3282.9",,"[expenditure, material-supply]"
"1","30/12/2019 00:00:00+00","-2145",,"[expenditure, material-supply]"
"1","30/12/2019 00:00:00+00","-2147.51",,"[expenditure, material-supply]"
"1","30/12/2019 00:00:00+00","-838",,"[expenditure, material-supply]"
"1","30/12/2019 00:00:00+00","-1656.6",,"[expenditure, material-supply]"
"1","30/12/2019 00:00:00+00","-1136.35",,"[expenditure, material-supply]"
"1","30/12/2019 00:00:00+00","-2048.81",,"[expenditure, material-supply]"
"1","30/12/2019 00:00:00+00","-2893.52",,"[expenditure, material-supply]"
"1","30/12/2019 00:00:00+00","-6221.13",,"[expenditure, material-supply]"
"1","30/12/2019 00:00:00+00","-2725",,"[expenditure, material-supply]"
"1","30/12/2019 00:00:00+00","-3154.49",,"[expenditure, material-supply]"
"1","30/12/2019 00:00:00+00","-14.88",,"[expenditure, material-supply]"
"1","30/12/2019 00:00:00+00","-1345.3",,"[expenditure, material-supply]"
"1","30/12/2019 00:00:00+00","-3782.87",,"[expenditure, material-supply]"
"1","30/12/2019 00:00:00+00","-1309",,"[expenditure, material-supply]"
"1","30/12/2019 00:00:00+00","-306.54",,"[expenditure, material-supply]"
"1","30/12/2019 00:00:00+00","-0.48",,"[expenditure, material-supply]"
"1","30/12/2019 00:00:00+00","-0.42",,"[expenditure, material-supply]"
"1","30/12/2019 00:00:00+00","-0.48",,"[expenditure, material-supply]"
"1","30/12/2019 00:00:00+00","-0.11",,"[expenditure, material-supply]"
"1","30/12/2019 00:00:00+00","-0.16",,"[expenditure, material-supply]"
"1","30/12/2019 00:00:00+00","-14039.43",,"[expenditure, material-supply]"
"1","30/12/2019 00:00:00+00","1000",,"[revenue]"
"1","30/12/2019 00:00:00+00","10",,"[revenue]"
"1","30/12/2019 00:00:00+00","8260",,"[revenue, sales]"
"1","30/12/2019 00:00:00+00","65000",,"[revenue, sales]"
"1","30/12/2019 00:00:00+00","2190.52",,"[revenue, sales]"
"1","30/12/2019 00:00:00+00","1095.26",,"[revenue, sales]"
"1","30/12/2019 00:00:00+00","1104.78",,"[revenue, sales]"
"1","30/12/2019 00:00:00+00","2381",,"[revenue, sales]"
"1","30/12/2019 00:00:00+00","8314.45",,"[revenue, sales]"
"1","30/12/2019 00:00:00+00","1285.74",,"[revenue, sales]"
"1","30/12/2019 00:00:00+00","4000.08",,"[revenue, sales]"
"1","30/12/2019 00:00:00+00","1904.8",,"[revenue, sales]"
"1","30/12/2019 00:00:00+00","6066.79",,"[revenue, sales]"
"1","30/12/2019 00:00:00+00","2952.44",,"[revenue, sales]"
"1","30/12/2019 00:00:00+00","6704.9",,"[revenue, sales]"
"1","30/12/2019 00:00:00+00","4495.33",,"[revenue, sales]"
"1","30/12/2019 00:00:00+00","1571.46",,"[revenue, sales]"
"1","30/12/2019 00:00:00+00","2381",,"[revenue, sales]"
"1","30/12/2019 00:00:00+00","3909.6",,"[revenue, sales]"
"1","30/12/2019 00:00:00+00","3238.16",,"[revenue, sales]"
"1","30/12/2019 00:00:00+00","490",,"[revenue, sales]"
"1","30/12/2019 00:00:00+00","9550",,"[revenue]"
"1","30/12/2019 00:00:00+00","1890",,"[revenue, sales]"
"1","30/12/2019 00:00:00+00","13806.51",,"[revenue, sales]"
"1","30/12/2019 00:00:00+00","-20000",,"[expenditure]"
"1","31/12/2019 00:00:00+00","6690",,"[revenue, sales]"
"1","31/12/2019 00:00:00+00","3952.46",,"[revenue, sales]"
"1","31/12/2019 00:00:00+00","3638.17",,"[revenue, sales]"
"1","31/12/2019 00:00:00+00","1771.46",,"[revenue, sales]"
"1","31/12/2019 00:00:00+00","3523.88",,"[revenue, sales]"
"1","31/12/2019 00:00:00+00","2752.44",,"[revenue, sales]"
"1","31/12/2019 00:00:00+00","1933.37",,"[revenue, sales]"
"1","31/12/2019 00:00:00+00","17626.66",,"[revenue, sales]"
"1","31/12/2019 00:00:00+00","22048.98",,"[revenue, sales]"
"1","31/12/2019 00:00:00+00","-4",,"[expenditure]"
"1","31/12/2019 00:00:00+00","-150.87",,"[expenditure]"
"1","31/12/2019 00:00:00+00","-5.2",,"[expenditure]"
"1","31/12/2019 00:00:00+00","-1",,"[expenditure]"
"1","31/12/2019 00:00:00+00","-3",,"[expenditure]"
"1","31/12/2019 00:00:00+00","-4.15",,"[expenditure]"
"1","31/12/2019 00:00:00+00","-1.15",,"[expenditure]"
"1","31/12/2019 00:00:00+00","-130.9",,"[expenditure]"
"1","2/1/2020 00:00:00+00","-4360.33",,"[expenditure, material-supply]"
"1","2/1/2020 00:00:00+00","-1371.71",,"[expenditure, material-supply]"
"1","2/1/2020 00:00:00+00","-2334.5",,"[expenditure, material-supply]"
"1","2/1/2020 00:00:00+00","-1029.01",,"[expenditure, material-supply]"
"1","2/1/2020 00:00:00+00","-390",,"[expenditure, material-supply]"
"1","2/1/2020 00:00:00+00","-3204.57",,"[expenditure, material-supply]"
"1","2/1/2020 00:00:00+00","-1549.5",,"[expenditure, material-supply]"
"1","2/1/2020 00:00:00+00","-1595.6",,"[expenditure, material-supply]"
"1","2/1/2020 00:00:00+00","-3984.52",,"[expenditure, material-supply]"
"1","2/1/2020 00:00:00+00","-8547.98",,"[expenditure, material-supply]"
"1","2/1/2020 00:00:00+00","-1549.5",,"[expenditure, material-supply]"
"1","2/1/2020 00:00:00+00","-2357.3",,"[expenditure, material-supply]"
"1","2/1/2020 00:00:00+00","-1267",,"[expenditure, material-supply]"
"1","2/1/2020 00:00:00+00","-1775.9",,"[expenditure, material-supply]"
"1","2/1/2020 00:00:00+00","-7749.96",,"[expenditure, material-supply]"
"1","2/1/2020 00:00:00+00","-1601.3",,"[expenditure, material-supply]"
"1","2/1/2020 00:00:00+00","-900",,"[expenditure, material-supply]"
"1","2/1/2020 00:00:00+00","-2382.6",,"[expenditure, material-supply]"
"1","2/1/2020 00:00:00+00","-6481.28",,"[expenditure, material-supply]"
"1","2/1/2020 00:00:00+00","-2597.6",,"[expenditure, material-supply]"
"1","2/1/2020 00:00:00+00","-3047.49",,"[expenditure, material-supply]"
"1","2/1/2020 00:00:00+00","-605.5",,"[expenditure, material-supply]"
"1","2/1/2020 00:00:00+00","-628.5",,"[expenditure, material-supply]"
"1","2/1/2020 00:00:00+00","-3015",,"[expenditure, material-supply]"
"1","2/1/2020 00:00:00+00","-2699.89",,"[expenditure, material-supply]"
"1","2/1/2020 00:00:00+00","-2587.31",,"[expenditure, material-supply]"
"1","2/1/2020 00:00:00+00","-5263.82",,"[expenditure, material-supply]"
"1","2/1/2020 00:00:00+00","-1865.2",,"[expenditure, material-supply]"
"1","2/1/2020 00:00:00+00","-1192.5",,"[expenditure, material-supply]"
"1","2/1/2020 00:00:00+00","-2542.21",,"[expenditure, material-supply]"
"1","2/1/2020 00:00:00+00","-1599.1",,"[expenditure, material-supply]"
"1","2/1/2020 00:00:00+00","-5734.03",,"[expenditure, material-supply]"
"1","2/1/2020 00:00:00+00","-1265.59",,"[expenditure, material-supply]"
"1","2/1/2020 00:00:00+00","-4570.57",,"[expenditure, material-supply]"
"1","2/1/2020 00:00:00+00","-3008.02",,"[expenditure, material-supply]"
"1","2/1/2020 00:00:00+00","-1518.3",,"[expenditure, material-supply]"
"1","2/1/2020 00:00:00+00","-1273.6",,"[expenditure, material-supply]"
"1","2/1/2020 00:00:00+00","-4116",,"[expenditure, material-supply]"
"1","2/1/2020 00:00:00+00","-1048.5",,"[expenditure, material-supply]"
"1","2/1/2020 00:00:00+00","-3994.9",,"[expenditure, material-supply]"
"1","2/1/2020 00:00:00+00","-3436.49",,"[expenditure, material-supply]"
"1","2/1/2020 00:00:00+00","-0.3",,"[expenditure, material-supply]"
"1","2/1/2020 00:00:00+00","-0.25",,"[expenditure, material-supply]"
"1","2/1/2020 00:00:00+00","-18594.17",,"[expenditure]"
"1","2/1/2020 00:00:00+00","-3570",,"[expenditure, rent]"
"1","2/1/2020 00:00:00+00","15360",,"[revenue, sales]"
"1","2/1/2020 00:00:00+00","15.61",,"[revenue]"
"1","2/1/2020 00:00:00+00","13.67",,"[revenue]"
"1","2/1/2020 00:00:00+00","5.33",,"[revenue]"
"1","2/1/2020 00:00:00+00","20.2",,"[revenue]"
"1","2/1/2020 00:00:00+00","21.02",,"[revenue]"
"1","2/1/2020 00:00:00+00","5810",,"[revenue]"
"1","2/1/2020 00:00:00+00","5380",,"[revenue]"
"1","2/1/2020 00:00:00+00","2110",,"[revenue]"
"1","2/1/2020 00:00:00+00","7260",,"[revenue]"
"1","2/1/2020 00:00:00+00","7800",,"[revenue]"
"1","2/1/2020 00:00:00+00","1270",,"[revenue]"
"1","2/1/2020 00:00:00+00","3920",,"[revenue]"
"1","2/1/2020 00:00:00+00","3910",,"[revenue]"
"1","2/1/2020 00:00:00+00","9500",,"[revenue]"
"1","2/1/2020 00:00:00+00","3700",,"[revenue]"
"1","2/1/2020 00:00:00+00","2010",,"[revenue, sales]"
"1","2/1/2020 00:00:00+00","3000",,"[revenue, sales]"
"1","2/1/2020 00:00:00+00","6870",,"[revenue]"
"1","2/1/2020 00:00:00+00","3067",,"[revenue, chargeback, sales]"
"1","3/1/2020 00:00:00+00","-5763.18",,"[expenditure, material-supply]"
"1","3/1/2020 00:00:00+00","-8537.61",,"[expenditure, material-supply]"
"1","3/1/2020 00:00:00+00","-13650.07",,"[expenditure, material-supply]"
"1","3/1/2020 00:00:00+00","-3807.98",,"[expenditure, material-supply]"
"1","3/1/2020 00:00:00+00","-2205.01",,"[expenditure, material-supply]"
"1","3/1/2020 00:00:00+00","-837.5",,"[expenditure, material-supply]"
"1","3/1/2020 00:00:00+00","-1637.1",,"[expenditure, material-supply]"
"1","3/1/2020 00:00:00+00","-3120.1",,"[expenditure, material-supply]"
"1","3/1/2020 00:00:00+00","-483",,"[expenditure, material-supply]"
"1","3/1/2020 00:00:00+00","-2982.88",,"[expenditure, material-supply]"
"1","3/1/2020 00:00:00+00","-2699.01",,"[expenditure, material-supply]"
"1","3/1/2020 00:00:00+00","-6847.96",,"[expenditure, material-supply]"
"1","3/1/2020 00:00:00+00","-1379",,"[expenditure, material-supply]"
"1","3/1/2020 00:00:00+00","-1868.4",,"[expenditure, material-supply]"
"1","3/1/2020 00:00:00+00","-2205.5",,"[expenditure, material-supply]"
"1","3/1/2020 00:00:00+00","-1532.9",,"[expenditure, material-supply]"
"1","3/1/2020 00:00:00+00","-2742.51",,"[expenditure, material-supply]"
"1","3/1/2020 00:00:00+00","-778",,"[expenditure, material-supply]"
"1","3/1/2020 00:00:00+00","-7764.5",,"[expenditure, material-supply]"
"1","3/1/2020 00:00:00+00","-1000",,"[expenditure, material-supply]"
"1","3/1/2020 00:00:00+00","-6884.49",,"[expenditure, material-supply]"
"1","3/1/2020 00:00:00+00","-3023.5",,"[expenditure, material-supply]"
"1","3/1/2020 00:00:00+00","-7671.11",,"[expenditure, material-supply]"
"1","3/1/2020 00:00:00+00","-6485",,"[expenditure, material-supply]"
"1","3/1/2020 00:00:00+00","-1390.34",,"[expenditure, material-supply]"
"1","3/1/2020 00:00:00+00","-3464.89",,"[expenditure, material-supply]"
"1","3/1/2020 00:00:00+00","-1368.5",,"[expenditure, material-supply]"
"1","3/1/2020 00:00:00+00","-516.89",,"[expenditure, material-supply]"
"1","3/1/2020 00:00:00+00","-17.02",,"[expenditure, transport, material-supply]"
"1","3/1/2020 00:00:00+00","-160.65",,"[expenditure, material-supply]"
"1","3/1/2020 00:00:00+00","-0.49",,"[expenditure, material-supply]"
"1","3/1/2020 00:00:00+00","-1514.32",,"[expenditure]"
"1","3/1/2020 00:00:00+00","-2859.32",,"[expenditure, material-supply]"
"1","3/1/2020 00:00:00+00","-3062.86",,"[expenditure, material-supply]"
"1","3/1/2020 00:00:00+00","-2059.57",,"[expenditure, material-supply]"
"1","3/1/2020 00:00:00+00","-7600",,"[expenditure]"
"1","3/1/2020 00:00:00+00","290",,"[revenue, sales]"
"1","3/1/2020 00:00:00+00","9840",,"[revenue]"
"1","3/1/2020 00:00:00+00","1409.55",,"[revenue, sales]"
"1","3/1/2020 00:00:00+00","1123.83",,"[revenue, sales]"
"1","3/1/2020 00:00:00+00","485.72",,"[revenue, sales]"
"1","3/1/2020 00:00:00+00","4666.76",,"[revenue, sales]"
"1","3/1/2020 00:00:00+00","1447.65",,"[revenue, sales]"
"1","3/1/2020 00:00:00+00","8828.75",,"[revenue, sales]"
"1","3/1/2020 00:00:00+00","6523.94",,"[revenue, sales]"
"1","3/1/2020 00:00:00+00","1285.74",,"[revenue, sales]"
"1","3/1/2020 00:00:00+00","2495.29",,"[revenue, sales]"
"1","3/1/2020 00:00:00+00","952.4",,"[revenue, sales]"
"1","3/1/2020 00:00:00+00","1809.56",,"[revenue, sales]"
"1","3/1/2020 00:00:00+00","2123.85",,"[revenue, sales]"
"1","3/1/2020 00:00:00+00","2381",,"[revenue, sales]"
"1","3/1/2020 00:00:00+00","4381.04",,"[revenue, sales]"
"1","3/1/2020 00:00:00+00","5038.2",,"[revenue, sales]"
"1","3/1/2020 00:00:00+00","1142.88",,"[revenue, sales]"
"1","3/1/2020 00:00:00+00","1380.98",,"[revenue, sales]"
"1","3/1/2020 00:00:00+00","3704.84",,"[revenue, sales]"
"1","3/1/2020 00:00:00+00","5338.2",,"[revenue, sales]"
"1","3/1/2020 00:00:00+00","3920",,"[revenue, sales]"
"1","3/1/2020 00:00:00+00","1917.54",,"[revenue, sales]"
"1","3/1/2020 00:00:00+00","3062.86",,"[revenue, sales]"
"1","3/1/2020 00:00:00+00","9160",,"[revenue, sales]"
"1","3/1/2020 00:00:00+00","5264.24",,"[revenue, sales]"
"1","3/1/2020 00:00:00+00","7703.96",,"[revenue, sales]"
"1","3/1/2020 00:00:00+00","5086.78",,"[revenue, sales]"
"1","3/1/2020 00:00:00+00","7120",,"[revenue, sales]"
"1","3/1/2020 00:00:00+00","4830",,"[revenue, sales]"
"1","3/1/2020 00:00:00+00","4613.68",,"[revenue, sales]"
"1","3/1/2020 00:00:00+00","3759.37",,"[revenue, sales]"
"1","3/1/2020 00:00:00+00","2940",,"[revenue, sales]"
"1","3/1/2020 00:00:00+00","2253.87",,"[revenue, sales]"
"1","3/1/2020 00:00:00+00","2592.68",,"[revenue, sales]"
"1","3/1/2020 00:00:00+00","6243.23",,"[revenue, sales]"
"1","3/1/2020 00:00:00+00","3247.02",,"[revenue, sales]"
"1","3/1/2020 00:00:00+00","8975.35",,"[revenue, sales]"
"1","3/1/2020 00:00:00+00","7027.14",,"[revenue, sales]"
"1","3/1/2020 00:00:00+00","2471.61",,"[revenue, sales]"
"1","3/1/2020 00:00:00+00","10380",,"[revenue, sales]"
"1","3/1/2020 00:00:00+00","2720.19",,"[revenue, sales]"
"1","3/1/2020 00:00:00+00","2623.04",,"[revenue, sales]"
"1","3/1/2020 00:00:00+00","1956.88",,"[revenue, sales]"
"1","3/1/2020 00:00:00+00","37262.07",,"[revenue]"
"1","3/1/2020 00:00:00+00","14707.2",,"[revenue, sales]"
"1","3/1/2020 00:00:00+00","-436.83",,"[expenditure, material-supply]"
"1","3/1/2020 00:00:00+00","-4.5",,"[expenditure, material-supply]"
"1","6/1/2020 00:00:00+00","-2409.51",,"[expenditure, material-supply]"
"1","6/1/2020 00:00:00+00","-6358",,"[expenditure, material-supply]"
"1","6/1/2020 00:00:00+00","-619",,"[expenditure, material-supply]"
"1","6/1/2020 00:00:00+00","-621",,"[expenditure, material-supply]"
"1","6/1/2020 00:00:00+00","-1848.8",,"[expenditure, material-supply]"
"1","6/1/2020 00:00:00+00","-35",,"[expenditure, material-supply]"
"1","6/1/2020 00:00:00+00","-3852.5",,"[expenditure, material-supply]"
"1","6/1/2020 00:00:00+00","-2247.9",,"[expenditure, material-supply]"
"1","6/1/2020 00:00:00+00","-682.5",,"[expenditure, material-supply]"
"1","6/1/2020 00:00:00+00","-2602.5",,"[expenditure, material-supply]"
"1","6/1/2020 00:00:00+00","-1913.5",,"[expenditure, material-supply]"
"1","6/1/2020 00:00:00+00","-1679.7",,"[expenditure, material-supply]"
"1","6/1/2020 00:00:00+00","-2645",,"[expenditure, material-supply]"
"1","6/1/2020 00:00:00+00","-1550",,"[expenditure, material-supply]"
"1","6/1/2020 00:00:00+00","-8032.8",,"[expenditure, material-supply]"
"1","6/1/2020 00:00:00+00","-13288.05",,"[expenditure, material-supply]"
"1","6/1/2020 00:00:00+00","-2039.5",,"[expenditure, material-supply]"
"1","6/1/2020 00:00:00+00","-2084.5",,"[expenditure, material-supply]"
"1","6/1/2020 00:00:00+00","-3114.48",,"[expenditure, material-supply]"
"1","6/1/2020 00:00:00+00","-28680.52",,"[expenditure, material-supply]"
"1","6/1/2020 00:00:00+00","-3285.45",,"[expenditure]"
"1","6/1/2020 00:00:00+00","6670",,"[revenue]"
"1","6/1/2020 00:00:00+00","1495.27",,"[revenue, sales]"
"1","6/1/2020 00:00:00+00","8090",,"[revenue]"
"1","6/1/2020 00:00:00+00","6360",,"[revenue]"
"1","6/1/2020 00:00:00+00","7710",,"[revenue]"
"1","6/1/2020 00:00:00+00","-4",,"[expenditure]"
"1","6/1/2020 00:00:00+00","22",,"[revenue]"
"1","6/1/2020 00:00:00+00","21",,"[revenue]"
"1","7/1/2020 00:00:00+00","-32.13",,"[expenditure, material-supply]"
"1","7/1/2020 00:00:00+00","-1294.13",,"[expenditure, material-supply]"
"1","7/1/2020 00:00:00+00","-46.41",,"[expenditure, material-supply]"
"1","7/1/2020 00:00:00+00","-506.23",,"[expenditure, material-supply]"
"1","7/1/2020 00:00:00+00","-476.83",,"[expenditure, material-supply]"
"1","7/1/2020 00:00:00+00","-47.08",,"[expenditure, material-supply]"
"1","7/1/2020 00:00:00+00","-140",,"[expenditure, material-supply]"
"1","7/1/2020 00:00:00+00","-387.51",,"[expenditure, material-supply]"
"1","7/1/2020 00:00:00+00","-6.5",,"[expenditure, material-supply]"
"1","7/1/2020 00:00:00+00","-821.1",,"[expenditure, material-supply]"
"1","7/1/2020 00:00:00+00","-940.1",,"[expenditure, material-supply]"
"1","7/1/2020 00:00:00+00","-595",,"[expenditure, material-supply]"
"1","7/1/2020 00:00:00+00","-6385.02",,"[expenditure, material-supply]"
"1","7/1/2020 00:00:00+00","-30",,"[expenditure, material-supply]"
"1","7/1/2020 00:00:00+00","-453",,"[expenditure, material-supply]"
"1","7/1/2020 00:00:00+00","-1532.49",,"[expenditure, material-supply]"
"1","7/1/2020 00:00:00+00","-944.71",,"[expenditure, material-supply]"
"1","7/1/2020 00:00:00+00","-12998.81",,"[expenditure, material-supply]"
"1","7/1/2020 00:00:00+00","-274.99",,"[expenditure, material-supply]"
"1","7/1/2020 00:00:00+00","-1364.3",,"[expenditure, material-supply]"
"1","7/1/2020 00:00:00+00","-8180.04",,"[expenditure, material-supply]"
"1","7/1/2020 00:00:00+00","-3770",,"[expenditure, material-supply]"
"1","7/1/2020 00:00:00+00","-3783.52",,"[expenditure, material-supply]"
"1","7/1/2020 00:00:00+00","-130",,"[expenditure, material-supply]"
"1","7/1/2020 00:00:00+00","-11445.5",,"[expenditure, material-supply]"
"1","7/1/2020 00:00:00+00","-4900",,"[expenditure, material-supply]"
"1","7/1/2020 00:00:00+00","-30",,"[expenditure, material-supply]"
"1","7/1/2020 00:00:00+00","-1509",,"[expenditure, material-supply]"
"1","7/1/2020 00:00:00+00","-1727.7",,"[expenditure, material-supply]"
"1","7/1/2020 00:00:00+00","-20113.44",,"[expenditure, material-supply]"
"1","7/1/2020 00:00:00+00","-2350",,"[expenditure, material-supply]"
"1","7/1/2020 00:00:00+00","-1477.6",,"[expenditure, material-supply]"
"1","7/1/2020 00:00:00+00","-1883",,"[expenditure, material-supply]"
"1","7/1/2020 00:00:00+00","-5382.48",,"[expenditure, material-supply]"
"1","7/1/2020 00:00:00+00","-2474",,"[expenditure, material-supply]"
"1","7/1/2020 00:00:00+00","-4434.43",,"[expenditure, material-supply]"
"1","7/1/2020 00:00:00+00","-3022.89",,"[expenditure, material-supply]"
"1","7/1/2020 00:00:00+00","-1249.5",,"[expenditure, material-supply]"
"1","7/1/2020 00:00:00+00","-5970.02",,"[expenditure, material-supply]"
"1","7/1/2020 00:00:00+00","-6815.02",,"[expenditure, material-supply]"
"1","7/1/2020 00:00:00+00","-3054.7",,"[expenditure, material-supply]"
"1","7/1/2020 00:00:00+00","-2370",,"[expenditure, material-supply]"
"1","7/1/2020 00:00:00+00","-9780",,"[expenditure, material-supply]"
"1","7/1/2020 00:00:00+00","-1403.87",,"[expenditure, material-supply]"
"1","7/1/2020 00:00:00+00","-150",,"[expenditure, material-supply]"
"1","7/1/2020 00:00:00+00","-718.92",,"[expenditure, material-supply]"
"1","7/1/2020 00:00:00+00","-3932.21",,"[expenditure, material-supply]"
"1","7/1/2020 00:00:00+00","-67718.03",,"[expenditure, material-supply]"
"1","7/1/2020 00:00:00+00","1220.16",,"[revenue, sales]"
"1","7/1/2020 00:00:00+00","2090",,"[revenue]"
"1","7/1/2020 00:00:00+00","80000",,"[revenue, sales]"
"1","7/1/2020 00:00:00+00","2381",,"[revenue, sales]"
"1","7/1/2020 00:00:00+00","1333.36",,"[revenue, sales]"
"1","7/1/2020 00:00:00+00","4095.32",,"[revenue, sales]"
"1","7/1/2020 00:00:00+00","2381",,"[revenue, sales]"
"1","7/1/2020 00:00:00+00","2704.82",,"[revenue, sales]"
"1","7/1/2020 00:00:00+00","2552.43",,"[revenue, sales]"
"1","7/1/2020 00:00:00+00","100",,"[revenue]"
"1","7/1/2020 00:00:00+00","1859.12",,"[revenue, sales]"
"1","7/1/2020 00:00:00+00","7830",,"[revenue, sales]"
"1","7/1/2020 00:00:00+00","2438.45",,"[revenue, sales]"
"1","7/1/2020 00:00:00+00","7799.73",,"[revenue, sales]"
"1","7/1/2020 00:00:00+00","100",,"[revenue]"
"1","7/1/2020 00:00:00+00","-35.97",,"[expenditure]"
"1","7/1/2020 00:00:00+00","-4",,"[expenditure, credit-card]"
"1","7/1/2020 00:00:00+00","-249.08",,"[leasing, expenditure, material-supply]"
"1","8/1/2020 00:00:00+00","-200",,"[expenditure, material-supply]"
"1","8/1/2020 00:00:00+00","-764.6",,"[expenditure, material-supply]"
"1","8/1/2020 00:00:00+00","-9127.36",,"[expenditure, material-supply]"
"1","8/1/2020 00:00:00+00","-3748.3",,"[expenditure, material-supply]"
"1","8/1/2020 00:00:00+00","-6859.17",,"[expenditure, material-supply]"
"1","8/1/2020 00:00:00+00","-190.9",,"[expenditure, material-supply]"
"1","8/1/2020 00:00:00+00","-4730",,"[expenditure, material-supply]"
"1","8/1/2020 00:00:00+00","-9659.91",,"[expenditure, material-supply]"
"1","8/1/2020 00:00:00+00","-30",,"[expenditure, material-supply]"
"1","8/1/2020 00:00:00+00","-3298.9",,"[expenditure, material-supply]"
"1","8/1/2020 00:00:00+00","-10224.89",,"[expenditure, material-supply]"
"1","8/1/2020 00:00:00+00","-9666.02",,"[expenditure, material-supply]"
"1","8/1/2020 00:00:00+00","-3503.4",,"[expenditure, material-supply]"
"1","8/1/2020 00:00:00+00","-9840",,"[expenditure, material-supply]"
"1","8/1/2020 00:00:00+00","-3490.48",,"[expenditure, material-supply]"
"1","8/1/2020 00:00:00+00","-3631",,"[expenditure, material-supply]"
"1","8/1/2020 00:00:00+00","-2018.5",,"[expenditure, material-supply]"
"1","8/1/2020 00:00:00+00","-200",,"[expenditure, material-supply]"
"1","8/1/2020 00:00:00+00","-1578.6",,"[expenditure, material-supply]"
"1","8/1/2020 00:00:00+00","-960.9",,"[expenditure, material-supply]"
"1","8/1/2020 00:00:00+00","-1856.9",,"[expenditure, material-supply]"
"1","8/1/2020 00:00:00+00","-30",,"[expenditure, material-supply]"
"1","8/1/2020 00:00:00+00","-8800",,"[expenditure, material-supply]"
"1","8/1/2020 00:00:00+00","-1249.5",,"[expenditure, material-supply]"
"1","8/1/2020 00:00:00+00","-6006.03",,"[expenditure, material-supply]"
"1","8/1/2020 00:00:00+00","-3740",,"[expenditure]"
"1","8/1/2020 00:00:00+00","-25316.98",,"[expenditure, material-supply]"
"1","8/1/2020 00:00:00+00","6504.89",,"[revenue, sales]"
"1","8/1/2020 00:00:00+00","3028.63",,"[revenue, sales]"
"1","8/1/2020 00:00:00+00","952.4",,"[revenue, sales]"
"1","8/1/2020 00:00:00+00","7428.72",,"[revenue, sales]"
"1","8/1/2020 00:00:00+00","1790.51",,"[revenue, sales]"
"1","8/1/2020 00:00:00+00","3228.64",,"[revenue, sales]"
"1","8/1/2020 00:00:00+00","13724.08",,"[revenue, sales]"
"1","8/1/2020 00:00:00+00","200",,"[revenue, sales]"
"1","8/1/2020 00:00:00+00","7630",,"[revenue]"
"1","8/1/2020 00:00:00+00","3920",,"[revenue]"
"1","8/1/2020 00:00:00+00","7520",,"[revenue, sales]"
"1","8/1/2020 00:00:00+00","50",,"[revenue, sales]"
"1","8/1/2020 00:00:00+00","-4",,"[expenditure, credit-card]"
"1","8/1/2020 00:00:00+00","-4",,"[expenditure]"
"1","8/1/2020 00:00:00+00","-15.1",,"[expenditure]"
"1","8/1/2020 00:00:00+00","34.08",,"[revenue]"
"1","9/1/2020 00:00:00+00","-30420",,"[expenditure, material-supply]"
"1","9/1/2020 00:00:00+00","-4737.88",,"[expenditure, material-supply]"
"1","9/1/2020 00:00:00+00","-530.73",,"[expenditure, material-supply]"
"1","9/1/2020 00:00:00+00","-178.5",,"[expenditure, material-supply]"
"1","9/1/2020 00:00:00+00","-23.8",,"[expenditure, material-supply]"
"1","9/1/2020 00:00:00+00","-4675.33",,"[expenditure, material-supply]"
"1","9/1/2020 00:00:00+00","-137.93",,"[expenditure, material-supply]"
"1","9/1/2020 00:00:00+00","-55.81",,"[expenditure, material-supply]"
"1","9/1/2020 00:00:00+00","1990",,"[revenue, sales]"
"1","9/1/2020 00:00:00+00","3771.5",,"[revenue, sales]"
"1","9/1/2020 00:00:00+00","3990.56",,"[revenue, sales]"
"1","9/1/2020 00:00:00+00","2338.57",,"[revenue, sales]"
"1","9/1/2020 00:00:00+00","23137.57",,"[revenue, sales]"
"1","9/1/2020 00:00:00+00","13200",,"[revenue, sales]"
"1","9/1/2020 00:00:00+00","3360",,"[revenue, sales]"
"1","9/1/2020 00:00:00+00","-12.57",,"[expenditure]"
"1","10/1/2020 00:00:00+00","-7600",,"[expenditure, material-supply]"
"1","10/1/2020 00:00:00+00","-39400.58",,"[expenditure, tax]"
"1","10/1/2020 00:00:00+00","-2192.5",,"[expenditure, material-supply]"
"1","10/1/2020 00:00:00+00","-2091.99",,"[expenditure, material-supply]"
"1","10/1/2020 00:00:00+00","-981.3",,"[expenditure, material-supply]"
"1","10/1/2020 00:00:00+00","-408",,"[expenditure, material-supply]"
"1","10/1/2020 00:00:00+00","-30",,"[expenditure, material-supply]"
"1","10/1/2020 00:00:00+00","-2239.11",,"[expenditure, material-supply]"
"1","10/1/2020 00:00:00+00","-2418.9",,"[expenditure, material-supply]"
"1","10/1/2020 00:00:00+00","-516",,"[expenditure, material-supply]"
"1","10/1/2020 00:00:00+00","-2879.98",,"[expenditure, material-supply]"
"1","10/1/2020 00:00:00+00","-25316.98",,"[expenditure, material-supply]"
"1","10/1/2020 00:00:00+00","3560",,"[revenue]"
"1","10/1/2020 00:00:00+00","9700",,"[revenue]"
"1","10/1/2020 00:00:00+00","4452.1",,"[revenue, sales]"
"1","10/1/2020 00:00:00+00","2830",,"[revenue, sales]"
"1","10/1/2020 00:00:00+00","4630",,"[revenue, sales]"
"1","10/1/2020 00:00:00+00","1661.26",,"[revenue, sales]"
"1","10/1/2020 00:00:00+00","100",,"[revenue]"
"1","10/1/2020 00:00:00+00","30",,"[revenue]"
"1","10/1/2020 00:00:00+00","100",,"[revenue]"
"1","10/1/2020 00:00:00+00","38419.09",,"[revenue, sales]"
"1","10/1/2020 00:00:00+00","113",,"[revenue, sales]"
"1","10/1/2020 00:00:00+00","-12300",,"[expenditure, material-supply]"
"1","10/1/2020 00:00:00+00","-4",,"[expenditure]"
"1","10/1/2020 00:00:00+00","-11102.62",,"[expenditure, material-supply]"
"1","10/1/2020 00:00:00+00","-88.27",,"[expenditure, material-supply]"
"1","10/1/2020 00:00:00+00","-2631.03",,"[expenditure, material-supply]"
"1","10/1/2020 00:00:00+00","-4",,"[expenditure, material-supply]"
"1","13/1/2020 00:00:00+00","21748.44",,"[revenue]"
"1","13/1/2020 00:00:00+00","100",,"[revenue]"
"1","13/1/2020 00:00:00+00","4950",,"[revenue]"
"1","13/1/2020 00:00:00+00","1160",,"[revenue]"
"1","13/1/2020 00:00:00+00","3880",,"[revenue]"
"1","13/1/2020 00:00:00+00","-33928.02",,"[expenditure, material-supply]"
